吖	啊
吖嗎	嗎
吖嘛	嘛
吖嗱	吧
亞	阿
呀	啊
亞爸	爸爸
亞伯	伯伯
亞跛	瘸子
亞保亞勝	張三李四
亞叉	印度人
亞燦	從內地來香港的新移民
亞大	老大
亞斗官	闊少爺
亞福	傻頭傻腦的人
亞甲亞乙	張三李四
亞狗亞貓	張三李四
亞哥	哥
亞姑	姑姑
亞公	外祖父
亞仔	兒子
亞吱亞咗	推三阻四
亞豬亞狗	張三李四
亞媽	媽媽
亞嫲	祖母
亞乜人	誰誰
亞茂	傻子
亞茂整餅	沒事找事
亞茂整餅，冇嗰樣整嗰樣	沒事找事，亂搞一氣
阿毛	老婆婆
亞妹	妹妹
亞奶	奶奶
亞女	女兒
亞奀	瘦子
亞婆	姥姥
亞生	先生
亞細	小老婆
亞嬸	嬸嬸
亞四	傭人
亞sir	長官
亞誰	誰
阿士匹靈	阿司匹林
阿星	阿三
亞傻	傻瓜
亞嫂	嫂子
亞叔	叔叔
亞頭	領導
亞駝	駝子
亞一	老大
亞爺	爺爺
亞姨	姨母
阿二	小三
呀	啊
account	會計學
唉唉聲	唉聲歎氣
IP	督察
哎吔	哎呀
暗瘡	粉刺
un	懂
out	過時
巴	巴掌
巴巴閉閉	咋咋呼呼
巴閉	厲害
巴揸	多嘴
巴黎帽	貝雷帽
吧女	酒吧女服務員
巴士	公車
巴士車長	公車司機
巴士站	公車站
巴士佬	公車司機
巴士司機	公車司機
把火	發火
把幾火	很生氣
把鬼	有什麼用
把鬼火	生氣
把口唔收	口無遮攔
罷啦	吧
把脈	診脈
把炮	本事
把屁	有屁用
把屁咩！	有個屁用！
把舦	掌舵
霸	佔
霸靚位	佔好位子
霸掗	霸道
霸位	佔位置
霸王	應付錢而不付錢
罷就	算了
拜拜	再見
擺	擺放
擺低	放下
擺檔	擺攤子
擺檔口	擺攤子
擺到明	擺明
擺款	擺架子
擺街	擺攤兒
擺街邊	擺攤兒
擺酒	設宴
擺老烏	做錯
擺甫士	擺姿勢
擺晒款	擺架子
擺烏龍	弄錯
拜山	上墳
敗家仔	敗家子
敗家精	敗家子
伯父	老頭
百家樂棋	雙陸棋
百足	蜈蚣
伯母	令堂
伯娘	伯母
伯爺	父親
伯爺公	老大爺
伯爺婆	老婆婆
百厭	調皮
百厭仔	淘氣鬼
百厭星	小傢伙
白車	救護車
白灼	水煮
白灼蝦	清煮蝦
白菜仔	小白菜
白䱽	銀鯧
白豆	大豆
白飯魚	文昌魚
白飯魚	白球鞋
白飯魚	銀魚
白粉	海洛因
白粉檔	販賣毒品的場所
白霍	輕浮
白霍友	好出風頭的人
白瓜	菜瓜
白滾水	白開水
白蚱	水母
白斬雞	白切雞
白淨	白嫩
白撞	小偷
白撞雨	過雲雨
白做	白幹了
白粥	稀飯
白賴嘥	白
白欖	數來寶
白欖	橄欖
白蒙蒙	白白的
白嘥	白費
白手興家	白手起家
白事	喪事
白蝕	汗斑
白線轆	白線軸兒
白雪雪	雪白
白話	粵語
白日流流	在光天化日之下
白油	醬油
白油	修正液
班	糾合
班	群
班兵	請援兵
班房	教室
班戟	薄煎餅
班祖琴	班卓琴
班馬	搬救兵
斑馬佬	兩面派
板	板子
辦	樣品
板斧	本事
板頸	脾氣倔強
板障	板牆
扮煮飯仔	過家家
扮	裝
湴	爛泥
扮蠢	裝傻
扮得意	裝可愛
扮癲扮傻	裝瘋賣傻
扮代表	裝模作樣
扮到	假裝
扮瞓	裝睡
扮鬼	裝神弄鬼
扮鬼扮馬	化妝
扮蟹	被捆起來
扮好人	裝好人
扮作	假裝
扮豬食老虎	佯裝愚蠢
扮煮飯仔	玩過家家
扮靚	打扮
扮靚仔	打扮得帥
扮靚靚	打扮得漂漂亮亮
扮冇事	裝作沒事
扮懵	裝傻
扮晒cool	裝出一副冷酷的樣子
扮晒嘢	裝模作樣
扮純情	裝可愛
扮笑	裝笑
扮傻扮懵	裝傻
扮聽唔到	裝作沒聽見
扮嘢	裝模作樣
扮英雄	充英雄
八	八卦的
八個字	四十分鍾
八卦	愛管閒事
八卦妹	愛管閒事的女孩
八卦婆	三八
八爪魚	章魚
八張幾	八十多歲
八字唔夾	八字不合
八妹	愛管閒事的女孩
八婆	三八
八仙枱	八仙桌
八音	民間音樂
包	準
包保	保證
包掂	保證搞好
包頂頸	專門跟別人抬槓
包伙食	伙食外包
包攪掂	一定弄妥當
包起	包下
包剪𢱕	石頭剪子布
包撞板	準碰釘子
包租	租房又分租給他人
包租公	二房東
包租婆	二房東太太
包粽	包粽子
包埋	包好
包屘	壓尾
包粟	玉米
包輸	輸定了
包二奶	有情婦
鮑魚刷	廁刷
飽擦一輪	飽吃一頓
飽得滯	太飽了
飽到上喉嚨椗	吃得太飽了
飽到上心口	吃得太飽了
飽死	臭美
飽死我啦！	飽到要爆炸
爆	炸
爆煲	露餡兒
爆坼	皴
爆坼膏	防裂油
爆粗	說粗話
爆粗口	說粗話
爆大鑊	揭底
爆燈	極高
爆火	發脾氣
爆格	發生搶劫案
爆夾	發生搶劫案
爆穀	爆米花
爆光	流血
爆響口	信口開河
爆血管	中風
爆樽	砸瓶
爆冷	出了意料不到的事情
爆冷門	發生出人意料的事
爆料	洩露秘密
爆滿	滿座
爆內幕	揭開內幕
爆棚	賣座
爆晒燈	非常
爆晒棚	坐滿了人
爆竊	失竊
爆呔	破輪胎
跛	瘸
跛腳	瘸腳
跛腳鴨	無能力的人
跛腳佬	瘸子
跛手	瘸胳膊
閉氣	憋氣
閉翳	憂愁
弊	糟
弊弊冇咁弊	糟了
弊處	壞處
弊傢伙	糟糕
弊就弊在	錯就錯在
弊喇	糟了
bio	生物學
北便	北邊
北芪	黃芪
北佬	北方人
泵	打
泵把	保險桿
泵車	抽水車
泵氣	打氣
泵水	抽水
賓賓	菲傭
賓仔	菲律賓少年
賓治	潘趣飲料
賓佬	菲律賓人
賓妹	菲律賓少女
賓婆	菲律賓人
笨豬跳	蹦極跳
笨實	蠢笨
崩	分錢
崩	破
崩口	豁嘴
崩口碗	缺口碗
崩口人忌崩口碗	當著矮子別說短話
崩仔	朋克
崩裝	莫西干頭
崩牙	缺齒
崩沙	大良崩砂
崩沙	大蝴蝶
𢳂	舀
不單止	不但
不特	不但
不特止	不但
𢳂飯	盛飯
不過不失	一般
筆嘴	筆尖兒
不知幾	很
𢳂垃圾	撮垃圾
不溜	一向
不文	下流的
不文動作	下流的動作
筆刨	鉛筆刀
𢳂水	舀水
不時	不定時地
筆塔	筆帽
𢳂湯	舀湯
不宜	不如
畢業相	畢業照
不如噉	這樣吧
不如下次先啦	下次吧
拔蘭地	白蘭地
睥	瞪
啤啤熊	泰迪熊
啤酒樽	啤酒瓶
啤酒肚	大肚子
啤梨	洋梨
啤梨	漿果
啤令	滾珠軸承軸承
啤一啤	喝一杯啤酒
畀	給
畀	被
髀	腿
畀差人拉	被警察逮捕
畀錢	付錢
畀錢我	給我錢
畀翻	還給
畀翻錢	還錢
畀非士	給面子
比堅尼	比基尼
畀過	交給
畀吓面	給點面子吧
畀考起	被考倒
畀著	換了
畀著你	換了你
畀著我	換了我
髀罅	腹股溝
畀利是	給紅包
畀嚟	拿來
畀雷劈	天殺的
比唔上	比不上
畀問起	被問倒
畀面	賞臉
畀面色佢睇	給臉色他看
畀鬧到死死吓	被罵得垂頭喪氣
畀鬧到一戙都冇	被罵得一錢不值
畀鬧到一隻屐	被罵得垂頭喪氣
畀鬧到一面屁	被罵得滿臉羞慚
畀銀紙	給錢
比併	比較
畀心機	用心
畀心機做	努力做
畀錫壞咗	被慣壞了
畀水沉死	被水淹死
畀水濁親	給水嗆了
畀雪藏	被打入冷宮
畀…睇	給…看
畀天收	遭天遣的
畀貼士	給小費
畀人踩	被別人壓住
畀人炒咗	被解僱
畀人砌	被人陷害
畀人唱衰	被別人詆毀
畀人棍咗	給人騙了
畀人蝦	軟弱
畀人恰	讓別人欺負了
畀人斬到一頸血	被宰了一筆
畀人祭旗	被人拿來開刀
畀人箍頸	被人搶劫
畀人坤咗	受騙
畀人賣豬仔	被出賣了
畀人鬧	捱罵
畀人呃	受騙
畀人拼沉	被打敗
畀人識穿	讓人識破
畀人玩死	被人害苦
比如話	譬如說
痺	麻
痺到死	肉麻死了
秘撈	搞外快
避	躲
避車	錯車
避車處	錯車的地方
避彈衣	防彈衣
避風塘	避風港
避忌	避諱
鼻哥	鼻子
鼻哥啄	鼻尖
鼻哥窿	鼻孔
避唔切	來不及躲開
避唔到	避不了
鼻腍	鼻塞
鼻水	鼻涕
鼻涕蟲	小孩子
band	樂團
band仔	樂手
餅乾	蘇打餅
餅仔	餅乾
餅咭	餅券
餅舖	餅店
餅師	麵包師傅
餅印	一模一樣
餅印	餅模子
柄	藏
柄埋	藏起來
病到聲沙	病得聲音沙啞了
病君	老病號
病咗	生病
啤	小孩
BB	哨子
BB機	呼叫機
啤啤	小孩
啤啤車	嬰兒車
啤啤仔	小嬰兒
啤啤女	女嬰兒
逼	擠
逼巴士	擠公車
逼爆	擠滿
逼到鬼噉	擠得要命
逼到冚晒	擠得水洩不通
逼到埋身	事情迫到頭上來
迫挾	擠
逼過嚟	擠過來
逼冚晒	擠得緊緊的
逼衡晒	緊緊地逼著
逼嚟逼去	擠來擠去
逼力	煞車
逼人	擁擠
逼入去	擠進去
邊	哪
鞭	鞭子
邊邊	哪邊
邊次	哪一次
邊度	哪裡
邊忽	哪兒
邊個	誰
邊個㗎	誰的？
邊個嘅	誰的
邊行	哪一行
辮仔	辮子
邊種	哪種
邊處	哪裡
邊處係呢	哪裡哪裡
邊一年	哪一年
邊日	哪一天
邊有	哪有
邊有咁大隻蛤乸隨街跳	天上不會掉餡兒餅
扁嘴	撇嘴
變翻	變回
變唔翻	變不回
便	面
便裝	便衣
便裝探員	便衣警員
乒乓波	乒乓球
冰室	冷飲店
抦	打
乒鈴𠾴唥	乒乒乓乓
咇	噴
咇出嚟	噴出來
標	噴
錶	手錶
錶板	儀表盤
標青	超群
標出	噴出
標出去	噴出去
標出嚟	噴出來
標到明	寫得很清楚
標高	長高
標汗	出汗
錶行	鐘錶店
標冷汗	出冷汗
標芽	出芽
標尿	屁滾尿流
標晒冷汗	出了一身冷汗
標參	綁架
標貼	張貼
標煙	冒煙
錶肉	錶瓤
表錯情	弄錯
波	奶
波	排檔
波	球
波板	球拍
波板糖	棒棒糖
波砵	球鞋
波缽	球鞋
波場	球場
波地	球場
波飛	球票
波褲	球褲
波棍	換檔桿；變速桿
波鞋	球鞋
坡紙	新元
波子	玻璃球
波子棋	跳棋
波珠	滾珠
波罅	乳溝
波樓	桌球房
玻璃樽	玻璃瓶
菠蘿	菠蘿
菠蘿包	波羅包
菠蘿彈	手榴彈
菠蘿雞	白吃白喝
菠蘿蓋	膝蓋骨
菠蘿麻	劍麻
菠蘿油	波羅包加牛油
波路	底細
波帽	鴨舌帽
波衫	球衣
波箱	變速箱
波裇	球衣
波士	老闆
波枱	球台
噃	喔
㩧	敲
㩧㩧齋	私塾
㩧親	砸傷
㩧落去	砸下去
㩧落嚟	砸下來
㩧濕	揍扁
㩧頭黨	擊頭黨
撲嘢	性交
壆	壠
搏	兌
搏	拼
膊	肩
駁	幾天
駁	接
駁	頂
搏炒	不想工作
駁長	接長
搏出位	爭著出人頭地
搏彩	碰運氣
搏大膽	賭膽量
搏大霧	揩油
搏到盡	盡全力
駁火	交火
駁腳	經紀
駁古	插嘴
駁骨	接骨
搏過	拼了
搏吓彩	碰碰運氣
駁嘴	頂嘴
駁嘴駁舌	頂嘴
搏盡	盡全力
駁住	連接
搏拉	做違法的事
搏老命	拼命
搏亂	鑽空子
搏命	拼命
搏命噉走	拼命地跑
搏懵	揩油
搏鋪大	賭一盤大的
搏晒老命	拼上老命
搏晒老命噉	拼命地
搏晒命	賣命
搏殺	大賭
搏殺	拼命
搏手	交手打架
搏死	拼死
駁水喉	接水管
駁線	接線
搏傻	裝瘋扮傻
膊頭	肩膀
搏同情	想別人同情
搏和	拼命守成平局
搏一鋪	試一下運氣如何
薄罉	薄餅
薄切切	薄薄的
薄英英	薄薄的
幫補	幫助補貼
幫襯	光顧
幫吓眼	幫著看一看
幫吓我眼	幫我看著點兒
幫口	幫腔
幫唔到	幫不了
幫唔到手	幫不上忙
幫眼	幫著看
幫手	幫忙
幫拖	幫忙
幫人孭數	幫人還債
綁到實	捆得結結實實的
綁個纈	打一個結
綁鞋帶	繫鞋帶
綁纈	打結
磅	給
磅水	給錢
傍	依靠
磅	過磅
傍家	戀家
傍水	護壁
煲	煮
煲	鍋
煲茶	熬藥
煲電話粥	打電話聊大天
煲飯	煮飯
煲咖啡	煮咖啡
煲仔飯	鍋飯
煲粥	煮粥
煲涼茶	煮去火湯藥
煲老藕	找老伴
煲唔腍	煮不爛
煲冇米粥	搞無米之炊
煲冇米粥，水汪汪	三十晚上走夜路，沒影兒的事
煲腍	煮爛
煲燶	煮焦
煲燶咗	煮焦了
煲水	燒水
煲水	瞎編
煲𧘹	領結
煲湯	煮湯
煲糖水	煮甜品
煲藥	熬藥
煲耳	鍋把
煲煙	抽煙
簿	本子
寶貝仔	寶貝兒子
補翻	補上
補家用	補貼家裡的開支
寶號	貴號
簿仔	小本子
保證金	押金
保住命仔	保住小命
褓姆車	校車
補𤶸	打補釘
保你大	服了你了
補衫	縫補衣服
補水	補助費
保鮮紙	玻璃紙
補數	補
補鑊	補救失誤
報串	告密
布甸	布丁
布公仔	布娃娃
布障	布幔
報紙佬	賣報的
佈置定當	佈置停當
布冧	洋李子
布碎	碎布
布頭布尾	碎布
哺	孵
埗	碼頭
哺竇	抱窩
哺竇雞	抱窩雞
哺竇雞乸	抱窩母雞
哺雞仔	孵小雞
報紙檔	報攤
暴冷暴熱	忽冷忽熱
暴瀉	急速下滑
埗頭	碼頭
杯	杯子
杯葛	抵制
杯仔蛋糕	紙杯蛋糕
杯薦	杯墊
杯耳	杯柄
背	背
背脊	背
背脊骨	脊椎
脊椎	脊椎
背脢	背脊
背囊	背包
背手影	背光
背式	仰泳
背	偏僻
背角	偏僻
book	預訂
book機票	訂機票
book酒店	訂酒店
book唔到位	訂不到座兒
book位	訂座兒
伏	趴
伏低	趴下
伏匿匿	捉迷藏
伏兒人	捉迷藏
搬竇	搬家
搬翻	搬回
搬翻去	搬回去
搬翻嚟	搬回來
搬屋	搬家
搬入	搬進
本地薑唔辣	遠來的和尚會念經
本嚟	本來
本銀	本金
本心	良心
本事	能幹
半親疏	半親不疏
半肥瘦	半肥不瘦
半公私	半公半私
半鹹淡	南腔北調
半截裙	裙子
半賣	半份
半男女	雙性人
半生熟	半生不熟
半世	半輩子
半世人	半輩子
半新舊	半新不舊
半天吊	掛在半空中
半條命	半死不活
半條人命	半死不活
半唐番	半中不西
半桶水	半瓶醋
埲	堵
𩗴	股
砵	靴
𠼭	嘟
𠼭𠼭	嘟嘟
𠼭𠼭車	汽車
缽仔糕	小缽糕
撥個輪	打電話
叉	叉子
蹅	誤踹
差遲	差錯
蹅錯腳	失腳
差啲	差一點
差啲領當喇	差一點上當了
叉電	充電
叉仔	印度少年
蹅落	踩到
叉佬	印度人
差唔多	差不多
叉妹	印度少女
差皮	差勁
叉婆	印度人
叉燒	烤肉
叉燒包	肉包
叉燒腸粉	紅燒肉粉條
叉燒飯	紅燒肉飯
叉燒醬	紅燒醬
叉燒酥	烤肉酥
叉燒肉	烤肉
差少少	差一點
差天共地	天壤之別
茶煲	麻煩
喳喳	鈸
查查	恰恰
查查舞	恰恰舞
茶餐廳	港式餐館
茶錢	酒飯錢
查緊	還在調查
茶瓜	醬瓜
茶瓜餸飯，好人有限	沙鍋滾下山，沒好的
搽口脣膏	塗口紅
茶走	奶茶不加糖
查牌	警察臨檢
查盤數	查賬目
查實	其實
搽脣膏	塗口紅
查數	查帳
茶壺耳	茶壺把
扠	塗
扠𢰸	弄壞
搓	揉
差辦	警察樣板
猜包剪𢱕	玩石頭剪子布
猜呈沉	石頭剪子布
搓粉	和麵
差館	警察局
搓雀	打麻將
猜拳	划拳
差佬	警察
搓麻雀	打麻將
猜枚	划拳
差婆	女警察
差人	警察
差人做嘢	警察辦案
踩爆	踏破
踩場	搗亂
踩錯腳	失腳
踩單車	騎自行車
踩低	搞垮
踩低人哋，抬高自己	壓低別人以抬高自己，打擊別人以抬高自己
踩界	踩線
踩過界	越界
踩雪屐	溜冰
踩軟索	走鋼絲
柴	柴火
柴可夫	司機
柴頭	警長
柴娃娃	鬧著玩
坼	裂開
拆簽	解釋簽上的文字
拆得開，鬥唔埋	拆得開，拼不上
拆掂	解決
拆檔	散伙
拆棚架	拆卸腳手架
拆棚做過	從零開始
賊	小偷
賊竇	賊巢
賊公	強盜
賊仔	小偷
賊佬	賊
charm	魅力
篸	箕
篸	簸箕
蠶	家蠶
慘情	悽慘
巉	刺眼
蠶春	蠶卵
巉眼	刺眼
劖	扎
劖親	扎破了
劖親簕	被刺刺著
劖損	劃破了
…餐飽	…個夠
餐薦	墊布
餐牌	菜單
餐屎	機會
餐枱	飯桌
餐搵餐食	掙一頓吃一頓
剷	推剪
剷青	兩邊推光的髮型
剷光頭	剃光頭
鏟泥車	挖土機
鏟泥機	挖土機
燦仔	新從內地來香港帶土氣的青年
燦妹	新從內地來香港帶土氣的姑娘
殘	疲勞
殘晒	精疲力盡
撐	支持
罉	鍋
撐到恆	支持到底
撐船	划船
撐艇仔	划船
橙	橙子
橙汁	柳橙汁
橙色	橘紅色
瞠	睜
瞠大隻眼	瞪大眼睛
瞠開	睜開
瞠開眼	睜開眼
瞠唔開	睜不開
瞠唔開眼	睜不開眼睛
撐枱腳	兩個人一起吃飯
棖	刺眼
棖雞	潑野
棖雞婆	潑婦
棖眼	刺眼
插贓	栽贓
插尿喉	插尿管
插水	假摔
插水	跳水
插蘇	插座
插蘇頭	插頭
擦	吃
擦餐飽	吃個飽
擦餐勁	吃個飽
擦餐懵	吃個飽
擦親	擦傷
擦翻餐	吃一頓
擦飯	吃飯
擦膠	橡皮擦
擦膠碎	橡皮屑
擦鞋	拍馬屁
擦鞋仔	馬屁精
擦紙膠	橡皮擦
擦字膠	橡皮擦
擦晒	擦掉
擦損	擦破
擦嘢	吃東西
抄低	抄下
抄唔切	來不及抄
抄牌	檢控
炒	倒騰買賣
炒	炒魷魚
炒車	出車禍
炒大鑊	吵架
炒粉	炒米粉
炒家	倒爺
炒更	加夜班
炒金	炒賣黃金
炒股	炒賣股票
炒股票	作股票的投機買賣
炒蝦拆蟹	說粗話
炒吓更	搞點兒外快
炒河粉	炒米粉條
炒齋河	素炒沙河粉
炒咗	被解僱
炒冷飯	炒剩飯
炒樓	倒買倒賣樓房
炒樓花	炒賣預售屋
炒老細魷魚	離職
炒孖展	作保證金信用的投機買賣
炒賣	小碟酒菜
炒買炒賣	倒買倒賣
炒賣	做投機生意
炒牛河	炒牛肉粉條
炒外幣	倒外幣
炒燶	炒糊了
炒燶咗	賣股票虧錢
炒黃牛	倒賣
炒友	倒爺
炒魷	炒魷魚
炒魷魚	炒魷魚
吵耳	刺耳
炒業	倒賣房產
抄	找
抄櫃桶	翻抽屜
抄身	搜身
巢	皺
巢𠵼𠵼	皺皺的
巢咪𠵼	皺皺的
巢皮	表面皺
巢皮咪𠵼	皮膚皺皺的
巢晒皮	皮膚皺皺的
淒涼	可憐
砌	打
砌	打
砌	拼
砌	編造
砌低	打敗
砌翻	拼起來
砌積木	搭積木
砌模型	拼模型
砌生豬肉	陷害
砌四方城	打麻將
砌雪人	堆雪人
砌圖	拼圖
砌人生豬肉	陷害人
齊齊	一起
齊葺葺	整整齊齊
齊黑	傍晚
齊整	整齊
齊晒	全齊了
齊頭	整
齊頭數	整數
侵早	清早
譖	羅嗦
譖氣	羅嗦
譖醉	羅嗦
譖趙	羅嗦
尋晚	昨晚
尋晚黑	昨晚
尋日	昨天
…親	…傷
…親	一…
…親	被…
親戚到	來月經
親戚巾	衛生巾
…親都…	一…
…親就…	一…
親子	父母和子女
親子關係	父母和子女的關係
親自下廚	親手做菜
親力親為	親自動手
親朋戚友	親戚朋友
親生	親
親生大佬	親哥哥
親生姊妹	親姐妹
襯	配
趁風使𢃇	見風使舵
襯家	親家
親家老爺	親家公
親家奶奶	親家母
趁高興	湊熱鬧
趁墟	趕集
趁墟打市	趕集
趁佢病，攞佢命	趁他病取他命，落井下石，打落水狗
襯裏	裏子
襯埋	配合
趁手	順手
趁熱鬧	湊熱鬧
趁熱食	趁熱吃
塵	傲慢
塵	塵土
陳皮	舊的
陳皮嘢	舊的東西
層	點
漆	油漆
七七八八	七八成
七彩	熱烈
七彩	色彩繽紛
七個字	三十五分鍾
七個一皮	非常忙亂
七國咁亂	亂七八糟
七張幾	七十多歲
漆油	油漆
揪	串
抽筋菜	空心菜
抽水	吞錢
抽水	揩油
抽油	醬油
籌	號兒
醜	羞
醜頸	脾氣差
醜怪	羞
醜怪	醜
醜吓佢	羞羞他
綢仔	絲綢
醜死怪	羞
醜死怪	醜
醜死鬼	羞死了
醜死鬼	羞
醜人	壞人
醜樣	醜
湊	照顧
臭烹烹	臭臭的
湊啤啤	帶孩子
湊大	帶大
臭亨亨	臭臭的
湊仔	帶小孩
湊仔婆	保姆
湊蹺	碰巧
臭𤓓	焦臭
湊埋	湊夠
湊啱	恰巧
湊細蚊仔	帶孩子
臭鍟𡃴	臭鐵鏽味兒
唓	呸
車	掄
車	縫
車	車子
車	載
車親	撞到
車大炮	吹牛
車飛	車票
車房	車庫
車衡晒	盡吹牛
車仔	洋車
車卡	車廂
車cam	行車記錄器
斜喱眼	斜眼
車厘子	櫻桃
車軨蓋	轂蓋
車轆	車輪
車埋去	開進去
車尾	車廂
車尾箱	行李箱
車牌	駕駛證
車衫	縫衣服
車死	撞死
車匙	汽車鑰匙
車呔	車胎
車呔肚	啤酒肚
車軚	方向盤
車天車地	吹牛吹得天花亂墜
車位	停車位
車葉	螺旋槳
扯	走
扯鼻鼾	打鼾
扯得	可以走
扯火	發火
扯哈	哮喘
扯氣	捯氣
扯旗	昇旗
扯𢃇	揚帆
扯貓尾	演雙簧
扯晒火	冒火了
扯晒哈	喘不過氣
扯線公仔	傀儡
斜	陡
邪	邪門
邪邪地	古古怪怪的
斜棟	斜線
邪骨	情色按摩
check	查
仄	支票
check吓	查查
仄紙	支票
赤	痛
赤猄	赤麂
赤𩶘	鯛魚
赤小豆	紅小豆
青瓜	黃瓜
青瓜椗	黃瓜蒂
青口	貽貝
青靚白淨	俊俏
青提子	青葡萄
青頭仔	童男
青頭女	處女
青衣	舒氏豬齒魚
青衣魚	舒氏豬齒魚
請槍	請人槍替
請飲	請客
請人	僱人
請人飲茶	請人下館子
請人飲餐茶	請人下館子
吹	抽
吹爆	氣死
吹BB	吹哨子
吹波	吹泡泡
吹波波	酒精測試
吹波膠	泡泡糖
吹波糖	泡泡糖
吹啲打	吹嗩吶
吹番梘泡	吹肥皂泡
吹雞	吹哨子
吹雞完場	吹哨子結束比賽
吹脹	奈何
吹脹	氣死
吹佢唔脹	奈何不了他
吹唔脹	奈何不了
催生晒	老催著
吹水	吹牛
吹鬚睩眼	吹鬍子瞪眼睛
娶心抱	娶媳婦
脆卜卜	脆脆的
趣怪	有趣
趣致	逗
脆皮	皮兒薄
脆皮叉燒	脆皮紅燒肉
捶	捶打
鎚	錘子
除	脫
𡃴	味道
除笨有精	塞翁失馬
隨便噏	隨便說說
除大赤腳	光腳
除大赤肋	光膀子
除低	脫下
除低眼鏡	摘下眼鏡
隨得	隨便
隨地𦧲	隨地吐痰
除褲	脫褲子
隨街	滿街
除鞋	脫鞋子
隨口噏	隨便說說
捶胸䂿腳	捶胸頓足
鎚仔	錘子
除咗	除了
除咗…之外	除了…之外
除咗…之外仲…	除了…之外還…
除落嚟	脫下來
除襪	脫襪子
除晒衫	脫光了衣服
除衫	脫衣服
除衫褲	脫衣褲
除手錶	脫下手錶
除裇衫	脫襯衫
隨時執生	隨機應變
灼	涮
卓頭	噱頭
春	蛋
春袋	陰囊
春孳	母雞腹內未成形的小蛋
春子	睪丸
蠢	笨
蠢頓	愚鈍
蠢到加零一	極愚蠢
蠢過隻豬	很笨
蠢人	笨蛋
循例	按慣例
窗	窗戶
窗鉸	窗合頁
窗口	窗戶
窗門	窗
搶翻	搶回
腸粉	蒸米粉卷兒
搶鏡	奪目
搶閘	搶先
腸仔	香腸
腸仔卷	香腸卷
搶眼	顯眼
搶手	暢銷
搶手貨	熱門貨
唱	胡說
暢	兌換
暢錢	找零錢給別人
唱碟	專輯
唱口	歌聲
唱口	風涼話
唱支歌仔	唱歌
唱作	作詞作曲及演唱
唱作歌手	創作歌手
唱作人	創作歌手
唱K	唱卡拉OK
暢唔開	破不開
唱片騎師	唱片節目播音員
唱片舖	唱片店
暢散紙	破零票
唱衰	到處說人壞話
唱衰佢	到處說他的不是
牆	牆壁
長砵	長靴
長過頭	太長了
長氣	囉唆
長氣袋	很囉嗦的人
長流流	長
長命斜	陡坡
長命債長命還	慢慢還債
長命雨	梅雨天
長衫	旗袍
出便	外面
出冊	出獄
出千	作弊
出沖	放炮
出啖氣	出一口氣
出得廳堂，入得廚房	裡裡外外一把手
出碟	出專輯
出翻嚟	出來
出埠	出遠門
出街	上街
出街買嘢	上街買東西
出街食	去外面吃飯
出街食飯	去外面吃飯
出更	上班值勤
出計	出主意
出鏡	露面
出蠱惑	耍花樣
出恭	大便
出公數	報銷
出去行吓	出去走走
出去蒲	出去玩
出汗	流汗
出閘口	出剪票口
出盡八寶	使盡渾身解數
出奇	奇怪
出嚟	出來
出嚟行	出來混
出嚟撈	出來混
出嚟蒲	出來玩
出糧	發薪水
出力	使勁
出力擝	使勁拉
出老千	作弊
出貓	作弊
出貓仔	作弊
出貓招	使詐
出貓招	偷襲
出面	外面
出面	表露出來
出門	外出
出門口	外出
出年	明年
出山	出殯
出生紙	出生證
出世	出生
出世紙	出生證
出聲	作聲
出水	涮
出水痘	長水痘
出水紙	提貨單
出術	騙人
出橫手	使出不光彩的手段
出位	突出
出夜街	晚上外出
出煙	冒煙
黐	粘
黐餐	蹭飯
黐黐哋	瘋瘋癲癲
黐黐𥹉𥹉	黏黏糊糊
黐纏	纏綿
粢飯	糍飯
黐飯餐	蹭飯
黐家	戀家
黐筋	神經病
黐立立	黏黏的
黐脷根	說話有點兒大舌頭
黐孖筋	神經病
黐埋	靠攏
黐埋嚟	靠過來
黐埋一齊	粘在一起
黐埋一笪	粘在一塊兒
黐𥹉𥹉	黏黏的
黐牙	黏牙
黐身	黏人
黐線	神經病
黐線佬	神經漢
黐飲黐食	白吃白喝
黐郵票	黏郵票
次次	每次
廁紙	衛生紙
廁所板	馬桶蓋
廁所泵	搋子
遲	晚
遲啲見	再會
遲啲再見	回頭見
遲啲	晚一點
匙羹	湯匙
辭工	辭職
遲吓	過些時候
遲早	早晚
遲晒	遲到
池魚	真鰺
似	像
恃	仗
似層層	好像真有其事
似似哋	有點兒像
似到極	像極了
似足	很像
恃老賣老	倚老賣老
似模似樣	像個樣子
似樣	像樣
似樣	像
簽	剔
簽牙	剔牙縫
撍	抽
撍出嚟	抽出來
潛質	潛力
撍豬毛	拔豬毛
潛烏龜	抽鬼
僭建	違章建築
千秋	鞦韆
千祈	千萬
千祈唔好	千萬不要
錢唔夠使	錢不夠花
錢銀	金錢
前便	前面
錢七	舊車
前嗰輪	前陣子
前嗰排	前陣子
前轆	前輪
後轆	後輪
錢罌	撲滿
前世	前生
前世撈亂骨頭	上輩子結了仇
前世唔修	前生缺乏修行
前一陣	前陣子
前一排	前陣子
前日	前天
青年仔	小伙子
清盤	清賬
掅	提
秤	磅秤
掅起	提起
掅起身	提起來
掅住	提著
掅住一袋嘢	提著一袋東西
埕	罈子
埕埕塔塔	情意纏綿
情信	情書
情願	寧可
cheap	低賤
cheap精	小氣鬼
cheap嘢	便宜貨
妾侍	小老婆
切奶	斷奶
切餸	切菜
超	太陽眼鏡
超	特別
超技術	作弊
超筍價	特價
潮州粥	稀飯
潮州音樂	自己顧自己
初不初	起初
初初	起初
初初入行	剛入門
初哥	生手
初嚟甫到	新來乍到
初時	起初
初頭	起初
初一流流	大年初一的
搓燕	踢毽子
搓圓撳扁	能屈能伸
錯蕩	走錯門
錯有錯著	歪打正著
鋤	背
鋤大弟	階級鬥爭
鋤書	啃書本
坐廁	坐式廁所
坐低	坐下
坐定	坐好了
坐定定	坐好
坐監	坐牢
坐櫃面	掌櫃
坐喺地下	坐在地上
坐起身	坐起來
坐陣	坐一會兒
坐正	坐穩
坐正	扶正
坐卡位	坐靠牆的座位
坐企身	坐起來
坐唔定	坐不住
坐唔正	沒坐穩
坐唔穩	坐不穩
坐埋一齊	坐在一起
坐食山崩	坐吃山空
坐船	乘船
坐月	坐月子
啋	呸
啋過你	呸！
啋過你把口	呸！
啋過你把衰口	呸！
啋過你，大吉利事	呸！大吉大利！
睬	理
睬佢都傻	不用管他
睬你都傻	不理你
彩數	運氣
菜膽	菜心兒
菜膽炒牛	菜心兒炒牛肉
菜乾	乾菜
菜螆	蚜蟲
菜牌	菜單
菜脯	蘿蔔乾
菜心	菜苔
菜薳	嫩菜薹
財主佬	有錢人
財路	收入來源
財務總監	財務長
剒	拽
剒樣	耍帥
倉	監獄
䱽魚	鯧
床	床鋪
床下底	床底
床薦	褥子
床褥	床墊
粗重嘢	重活
粗口	粗話
粗口爛舌	說話粗鄙下流
粗身大細	懷孕
草花頭	草頭兒
草紙	衛生紙
草蜢	蚱蜢
草披	草地
躁	煩躁
躁	燥
躁暴	性急
醋埕	愛吃醋的人
醋埕	醋缸子
躁火	性急
嘈	吵
嘈	爭吵
槽	養膘
曹白	鰳魚
嘈吵	喧嘩
嘈嘈閉	吵吵鬧鬧
嘈得滯	太吵了
嘈到死	吵死了
槽肥	動物養膘
嘈交	吵架
槽雞	把雞養膘
嘈起上嚟	吵起來
嘈喧巴閉	吵吵嚷嚷
槽鵝	把鵝養膘
嘈生晒	吵死人
嘈醒	吵醒
儲	存
儲錢	存錢
儲埋	存儲
儲郵票	集郵
速速	快點
速遞	快遞
速遞車	快遞車
速遞員	快遞員
畜牲	牲口
涌	小河
沖茶	沏茶
沖菜	大頭菜的一種
充充電	休息一下
充大頭鬼	打腫臉充胖子
衝燈	闖紅燈
蔥度	葱段
充闊佬	裝成有錢人
沖個靚涼	洗個痛快澡
沖滾水	打開水
沖滾水	灌開水
沖涼	洗澡
沖涼房	洗澡間
衝埋去	衝過去
衝埋嚟	衝過來
衝埋黎	衝過來
沖淡水	潑冷水
衝入嚟	闖進來
蟲仔	小蟲
蟲	昆蟲
重重沓沓	重重疊疊
重讀	留班
松雞	松果
從嚟	從來
松毛	松針
重皮	貴
重手	用力
廚房佬	廚師
柱躉	柱石
穿	破
穿崩	穿幫
穿煲	暴露
穿咗窿	穿了孔
穿窿	孔
穿窿	穿洞
穿梭機	航天飛機
串	拼
串	發橫
串錯	拼錯
串錯字	拼錯字
串仔	流氓
串字	拼字
串女	女流氓
全場爆滿	滿座全場
傳菜	端菜
全盒	攢盒
打令	愛人
打	加
打靶	槍決
打靶鬼	該死的
打靶佬	該死的
打包踭	用肘部撞人
打爆機	破紀錄
打崩頭	打破頭
打鼻鼾	打呼嚕
打邊爐	涮鍋子
打波	打球
打搏成	打西洋拳
打煲𧘹	打領結
打簿	打存摺
打喳喳	擊鈸
打車輪	接吻
打赤腳	光著腳
打出	露出
打出腳骨	露出小腿
打出心口	露出胸脯
打出膝頭哥	露出膝蓋
打出手骨	露出胳膊
打千秋	盪鞦韆
打錯電話	撥錯了號
打穿	打破
打打殺殺	打架殺人
打大赤腳	光腳
打大赤肋	光膀子
打大翻	翻跟頭
打大交	激烈的搏鬥
打低	打倒
打底褲	保險短褲
打得	能打
打突	事情來得很突然
打突兀	事情來得很突然
打掂	直著
打掂瞓	直著睡
打掂放	直著放
打掂寫	直著寫
打碟	播歌
打倒掟	倒過來
打倒掟放	倒過來放
打到甩肺	被人打得半死
打倒褪	倒退
打翻電話	回電話
打風	颳颱風
打格仔	打上馬賽克
打交	打架
打攪	打擾
打攪晒	打擾了
打救	搭救
打機	打電動
打機室	遊戲室
打個響指	彈響指頭
打工	工作
打工廠工	在工廠做工
打功夫	打拳
打工仔	工人
打工妹	女工人
打瓜	打死
打關斗	翻跟頭
打喊路	打哈欠
打乞嗤	打噴嚏
打芡	勾芡
打荷包	偷錢包
打齋	做法事
打雜	幹雜工
打仔	幹雜務的
打仔	打手
打掣	開閘
打側	側著身子
打側坐	側著身子坐
打側瞓	側著身子睡
打側身	側著身子睡
打真軍	真幹
打震	發抖
打雀	打麻將
打指模	按指印
打自己工，自己話事	自己當老闆可說話
打櫼	插隊
打政府工	當公務員
打咗個突	愣了一下
打樁	奠基
打交叉	打叉
打茄輪	接吻
打爛	打破
打爛齋缽	開齋
打爛砂盆問到篤	打破沙鍋問到底
打冷	夜宵
打冷震	發抖
打蠟	上蠟
打理	管
打雷公	打雷
打纈	打結
打窿機	打孔機
打唔通	打不通
打麻雀	打麻將
打埋	連
打牙骹	閒聊
打昂	仰著
打昂瞓	仰睡
打牌	打麻將
打披	打撲克
打晒纈	交通堵塞
打散工	做零工
打生打死	出生入死
打手板	打手心
打手指模	按指印
打蛇餅	大排長龍
打死纈	打死結
打死唔信	怎麼也不相信
打賞	獎賞
打思噎	打嗝兒
打屎窟	打屁股
打骰	掌權
打算點啫	打算怎麼著
打𧘹	繫領帶
打剔	勾
打鐵佬	鐵匠
打枱波	打桌球
打颱風	颳台風
打橫	橫著
打橫打掂	橫七豎八的
打橫瞓	橫著睡
打橫放	橫著放
打橫行	橫行霸道
打橫嚟	不講理
打橫寫	橫著寫
打橫睇	橫著看
打和	平手
打皇家工	當公務員
打噎	打嗝兒
打魚佬	漁夫
打預	打算
打完齋唔要和尚	念完經趕和尚
戴超	戴太陽眼鏡
帶街	導遊
帶挈	提攜
帶遮	帶傘
帶嚟	帶來
帶埋	帶上
帶眼	有眼力
帶眼識人	小心交友
帶手信	帶禮物
大	嚇唬
大巴	公車
大把	很多
大把錢	很多錢
大把世界	前景光明
大把時間	很多時間
大把人	很多人
大伯	大伯子
大班	洋行裡的總經理
大包	肉包子
大笨象	大象
大髀	大腿
大鼻	高傲
大寶號	貴號
大步擸過	大步跨過
大步𨂾過	一步跨過去
大茶飯	大案
大出血	大降價
大前日	大前天
大清早流流	大清早的
大情大性	大大咧咧
大菜	洋菜
大床	雙人床
大大啖	大口
大大話話	少說
大單	大量
大笪地	夜市
大得滯	太大了
大地魚	比目魚
大癲大廢	大大咧咧
大碟	專輯
大檔	賭攤
大花大朵	花哨
大花灑	亂花錢的人
大花筒	亂花錢的人
大翻	跟頭
大番薯	笨人
大家都噉話	彼此彼此
大家噉話	彼此彼此
大家姐	大姐
大假	長假
大街大巷	大街上
大覺瞓	睡大覺
大吉利事	大吉大利
大吉利事講句	難聽點說句
大嚿	健碩
大嚿衰	傻大個
大頸泡	甲狀腺腫
大件事	大事不好
大個	大
大個仔	長大了
大個仔囉	長大了
大個咗	長大了
大個女	長大了
大倌	大少爺
大客仔	大主顧
大後日	大後天
大戲	粵劇
大鄉里	土包子
大閘	大門
大閘蟹	河蟹
大劑	麻煩大
大陣仗	嚴重
大姐仔	小姑娘
大隻	個兒大
大隻講	瞎扯
大隻騾騾	人高馬大
大隻佬	大個兒
大資爺	驕傲
大字	毛筆字
大蕉	芭蕉
大咗肚	懷孕了
大狀	大律師
大早	早已
大舅	大舅子
大葵扇	媒人
大菌食細菌	不乾不淨
大粒癦	大官
大粒骰	大官
大褸	大衣
大律師	訴訟律師
大力	使勁
大力敲打	使勁敲打
大力透氣	大口喘氣
大佬	哥哥
大佬	老兄
大佬	頭目
大老倌	名藝人
大陸仔	內地青年
大陸妹	內地姑娘
大唔透	老小孩
大馬	馬來西亞
大賣	高傲
大命	命大
大模斯樣	大搖大擺
大懵	糊塗
大粒	大顆
大粒	達官
大粒佬	大人物
大粒嘢	大人物
大牙	臼齒
大嗌	尖叫
大眼雞	大眼鯛
大銀	硬幣
大牌	氣派大
大牌檔	路邊的小吃攤檔
大炮	大話
大炮友	火炮
大被冚過頭	睡大覺
大婆	正妻
大破慳囊	毫不吝嗇
大嘥	浪費
大嘥大使	大手大腳花錢
大晒	了不起
大使	揮霍
大使大食	大吃大喝
大細超	不公平
大細佬	長不大的孩子
大細眼	眼睛一大一小
大手筆	闊氣
大蛇屙尿	大場面
大石責死蟹	被迫服從
大聲公	大嗓門
大聲公	揚聲器
大信封	解僱信
大食	能吃
大食懶	好吃懶做
大食懶起身晏	骨頭懶起得晚
大少少	大一點
大少	丈夫的大哥
大少	大少爺
大騷	大型演出
大樹菠蘿	菠蘿蜜
大頭菜	蕪菁
大頭鬼	闊氣的人
大頭蝦	粗心的人
大頭綠衣	警察
大頭魚	鱅魚
大肚	懷孕
大肚腩	大肚皮
大肚婆	孕婦
大話	謊言
大話鬼	騙子
大話精	騙子
大話骰	吹牛
大胃王	飯量大的人
大鑊	麻煩
大鑊飯	大鍋飯
大飲大食	大吃大喝
大人大姐	大人
大人公	公公
大嘢	傲慢
大姨	大姨子
大姨媽	大姨
大耳窿	放高利貸的人
大煙通	火葬場
大熱症	傷寒
大魚	鱅魚
擔	叼
擔	挑
眈	看
覘	抬
擔保信	掛號信
擔鋤頭	扛鋤頭
擔大旗	指揮
擔凳	搬椅子
擔凳仔	搬椅子
擔綱	當主角
覘高個頭	抬起頭來
擔走	叼走
擔遮	打傘
擔住	叼著
擔住口煙	叼著一支煙
擔唔喐	挑不起
擔沙塞海	勞而無功
擔水	挑水
眈天望地	東張西望
擔枱擔凳	搬桌子
膽粗	膽大
膽粗粗	膽大
膽囊	膽囊
膽生毛	膽大包天
膽色	膽量
擔竿	扁擔
擔挑	扁擔
啖	口
淡淡定定	從容不迫
啖啖肉	果肉飽滿
淡定	鎮定
淡定啲	鎮定一點
單	帳單
單車	腳踏車
單車泵	打氣筒
單車徑	自行車道
單車掣	自行車車閘
單車鍊	鏈條
單車舖	自行車店
單車鎖匙	自行車鑰匙
單單	只
單單打打	冷言冷語
單對單	一對一
單係	光是
單起隻眼	閉起一隻眼
單企人	單人旁
單眼	擠眼
單眼	獨眼
單眼仔	獨眼龍
單眼佬	獨眼龍
單眼簷	單眼皮
單身寡仔	單身漢
單身寡佬	單身漢
單聲	說一聲
單思	單相思
單位	套間
單嘢	事件
彈床	彈簧床
蛋花糖水	雞蛋甜湯
但凡	凡是
疍家	疍民
彈弓	彈簧
彈弓床	沙發床
但係	但是
彈開	滾開
蛋治	煎雞蛋三明治
彈牙	脆
蛋饊	排叉兒
蛋撻	蛋塔
嗒	咂
嗒嗒聲	咂嘴聲
嗒真	細細品嚐
嗒真啲	細細品嚐
嗒真吓	細細品嚐
嗒落有味	耐人尋味
嗒糖	咂糖果
搭霸王車	坐車不買票
搭膊	搭肩
搭車	乘車
搭錯車	乘錯車
搭錯線	打錯了電話
搭錯線	誤會
搭的	招呼出租汽車
搭的士	搭乘出租車
搭艔	坐渡輪
搭艔過海	坐渡輪過江
搭夠	湊夠
搭句說話	帶個話兒
搭客	乘客
搭客	載客
搭嘴	插嘴
搭住膊	搭著肩
搭住膊噉行	搭著肩走路
搭𨋢	搭電梯
搭路	搭關係
搭路	通融
答唔切	來不及回答
搭棚	搭腳手架
搭順風車	搭便車
搭上搭	轉託
搭食	搭伙
搭小巴	乘坐小型公共汽車
搭van仔	坐小巴
沓	疊
沓崩	有錢
沓正	整
沓正…點	…點整
沓正…點	…點整
沓埋心水	專心一意
沓米	有錢
沓水	有錢
撻	糊
撻	躺倒
笪	塊
笪	摔
笪	竹蓆
𢴈	摔
笪餐死	摔了個半死
笪親	摔了一跤
笪低	摔了下來
笪落床	倒在床上
笪落地	摔下地
𢴈落嚟	摔下來
笪生魚	重重地摔了一跤
笪死	摔死了
笪傷	摔傷了
低B	蠢笨
低波	低速
低波	風格低
低波行駛	低速開車
低低哋	有點蠢笨
低低哋	水平差
低能	智障
低能兒童	智障少年
低威	比不上
低音結他	貝斯
抵	值得
抵	耐
抵埗	抵達
抵錢	值錢
抵打	該揍
底底	內褲
抵得	能夠忍受
抵得頸	忍得住氣
抵得諗	能忍讓
抵得痛	禁得住疼
抵到飛起	很值
抵到爛	太值
抵罰	該罰
底褲	內褲
抵頸唔住	忍不住
底裙	襯裙
抵冷	耐寒
抵力	吃力
抵買	值得買
抵鬧	欠罵
抵諗	能忍讓
抵你死	活該
底衫	內衣
底薪	基本工資
抵手	能幹
抵死	該死
抵死友	缺德鬼
抵錫	乖
抵食	值得吃
抵肚餓	捱餓
底橫	內褲
渧	滴
諦	諷刺
渧乾	滴乾
第	別
遞	舉
遞畀	遞給
第便	別的地方
第次	下次
第啲	別的
第度	別處
弟婦	弟妹
第件事	另外一件事情
第個	別的
第個禮拜	下個星期
第個人	別人
第個月	下個月
遞高	舉起來
遞高隻腳	把腳抬起來
遞高隻手	舉起手來
遞起	舉起
遞起手踭	抬起胳膊
第晚	改天晚上
第屘	最末
第世	來生
第時	以後
第處	別的地方
第一時間	立刻
第日	改天
第樣嘢	另外一樣東西
第二	別的
第二次	下次
第二啲	別的
第二度	別的地方
第二個	別的
第二樣	別的
得	光
得	可以
得把口	瞎吹
得把聲	瞎吹
得戚	得意
得敕	神氣
得敕喇你	有什麼可神氣的
得切	來得及
得啖笑	笑一笑
得啖笑啫	只不過笑一笑罷了
得翻	才有
得㗎啦	沒問題
…得交關	…得很厲害
得記	成功
得個	只剩
得個吉	一場空
得個講字	光說不幹
得閒	有空
得滯	過於
得就得，唔得就翻順德	行就吃龍蝦，不行就回老家
得…啫	只有…
得罪晒	得罪了
得直	勝訴
得喇	行了
得唔得	可不可以
得米	得手
得人驚	嚇人
得人憎	討人厭
得人怕	嚇人
得一想二	得寸進尺
得意	可愛
得意趣致	可愛有趣
特登	特地
揼	磨蹭
揼波鐘	耽誤
揼工	費時間
揼時間	磨時間
抌	扔
抌	砸
抌本	破費
抌低	扔下
抌開	扔開
抌咗	扔了
抌咗都冇人執	扔了也沒有人撿
抌落街	扔到街道上
抌心口	捶胸
抌印	蓋章
抌遠啲	扔遠一點
髧	垂
髧落	垂下
髧落去	垂下去
髧落嚟	垂下來
𨂽	跺
𨂽𨂽趯	噔噔地跑
𨂽地	跺腳
𨂽腳	跺腳
躉	底座
躉	放
躉	臀
躉大	屁股大
躉低	放下
躉貨	囤貨
躉落地	放在地上
躉唔落	放不下
扽	震
扽出嚟	抖出來
扽扽吓	顛簸
扽監	蹲監獄
扽氣	出氣
扽手踭	撞擊
燉冬菇	解僱
燈膽	電燈泡
燈籠椒	青椒
等	讓
等錢使	手頭緊
等到頸都長	等得很久了
等吓	等一等
等陣	等一下
等陣先	先等一下
等咗好耐	等了很久
等𨋢	等電梯
等唔切	不等了
等埋	等等
等我嚟	讓我來
等我睇吓	讓我看看
等人用	人手不夠
凳	椅子
凳仔	椅子
戥	壓
戥	替
戥穿石	伴郎
戥腳	湊數
戥興	湊熱鬧
戥你歡喜	替你高興
戥你開心	替你高興
戥你唔抵	替你不忿
戥你難過	替你難過
戥頭	平衡
戥穩	扶穩
耷	垂下
耷逼力	煞
耷低	垂下
耷低頭	垂頭
耷唔切	來不及煞車
耷濕	沒分寸
耷頭耷腦	垂頭喪氣
𢱕	砸
𢱕邪骨	去按摩院做情色按摩
𢱕金龜	向妻子要錢
𢱕骨	按摩
𢱕骨場	按摩院
𢱕骨妹	按摩女郎
𢱕吓條腰	捶捶腰
𢱕欖核	砸橄欖核
𢱕鐵	打鐵
𢱕一拳	打一拳
凸眼	眼球鼓起
兜	碗
兜	繞
蔸	棵
兜巴升	打耳光
兜風耳	招風耳
兜過	繞過去
兜口兜面	面對面
兜圈	繞圈子
兜轉頭	掉頭
兜嚟兜去	轉來轉去
兜路	繞道
兜路行	繞開別人走
兜踎	難看
兜彎	繞彎
豆	豆子
斗令	半角錢
斗零	半角錢
竇	窩
鬥	拼合
鬥	比賽
鬥	碰
鬥	逗
鬥駁	辯論
鬥撐	看誰堅持得久
鬥車	賽車
鬥大膽	比膽子大
鬥大力	比氣力
鬥𢴈	比摔跤
鬥到七彩	鬥個你死我活
鬥快	比快
鬥負氣	鬥彆扭
鬥雞眼	對眼
鬥個木桶	做一個木桶
竇口	住宅
鬥氣	賭氣
鬥走	賽跑
鬥蟀	鬥蟋蟀
鬥棋	兌子
鬥叻	比能力
鬥靚	比美
鬥龍船	賽龍舟
鬥唔埋	拼不上
鬥木	做木器
鬥木佬	木匠
鬥木師傅	木匠
鬥細佬哥	逗小孩
鬥醒	比闊氣
鬥一張枱	做一張桌子
豆	取
豆丁	小不點兒
豆丁仔	小不點兒
豆粉	澱粉
豆腐煲	沙鍋豆腐
豆腐花	豆腐腦
豆腐卜	豆泡
豆腐膶	豆腐干
豆角	豇豆
豆住	托著
豆利是	拿紅包
豆奶	豆漿
豆泥	劣
豆泥嘢	次貨
豆皮	麻臉
豆皮佬	麻子
豆卜	豆泡
豆沙喉	沙嗓子
豆膶	豆乾
豆蓉	豆泥
爹哋	爸爸
爹哋媽咪	爸爸媽媽
嗲	嬌
嗲聲嗲氣	嬌裡嬌氣
嗲	扯
嗲嗲渧	流個不停
…哋	有點…
哋	們
地包天	倒口牙
地埗	地址
地產	房地產
地底	地下
地底泥	次品
地庫	地下室
地庫商場	地下商場
地腳	地基
地下	地上
地氊	地毯
地牢	地窖
地牢商場	地下商場
地踎	地痞
地面化	公開化
地盤	工地
地盤工人	建築工人
地頭	地盤
地頭蟲	地頭蛇
地拖	拖把
地塘	曬場
趯	跑
趯	驅趕
趯更	逃亡
趯佬	走人
趯唔切	跑不掉
笛	吩咐
釘	死
釘翻粒鈕	把釦子縫上
釘蓋	死
釘仔	釘子
釘咗	死了
釘咗蓋	死了
釘鈕	縫上釦子
釘書機	訂書機
掟	投
掟標槍	擲標槍
掟波	扔球
掟煲	吹了
掟親	打傷
掟出	扔出
掟出街	扔出去
掟出去	扔出去
掟穿頭	砸破了頭
掟飛鏢	投鏢
掟貨	拋售
掟走	扔掉
掟中	扔中
掟球	扔球
掟落	扔下
掟落水	扔進水裡
掟銀仔	擲硬幣
掟手榴彈	投手榴彈
掟石頭	扔石頭
掟彎	轉彎
掟鉛球	推鉛球
埞	地方
定	定金
埞方	地方
訂房	訂房間
掉	丟
掉低	丟下
掉咗	扔了
掉嘢	把沒用的東西扔掉
對	對聯
隊	隊伍
𢷮	捅
隊啤	喝啤酒
𢷮鬼	慫慂
隊酒	喝酒
𢷮住度門	頂住門
𢷮冧	毆打
對辦	符合樣品
對出	靠外
對得住	對得起
對家	對面
對講機	步行機
對開	對過
對胸衫	對襟衫
對鐘	對時間
對摳	各半攙和
對唔住	對不起
對埋	靠裡邊
對我嚟講	對我來說
對上	以上
隊目	隊長
斫	剁
鈍	遲鈍
啄	啄
啄	小尖
啄親	叮
啄啄	尖端
啄啄糖	叮叮糖
啲	一些
啲打	嗩吶
啲啲	一點點
啲…點賣呀？	…多少錢？
啲朋友	朋友們
detail	細節
啲人	人們
弟	撲克牌中的“2”
啲啲震	發抖
的	乘出租車
的	提
的達舞	踢踏舞
的起嚟	提起來
的起心肝	立下決心
的去	乘出租車去
的士	出租車
的士佬	出租車司機
的士高	迪斯科
的式	精緻
的而且確	千真萬確
點	怎麼
點	指點
點	蘸
點辦	怎麼辦
點不知	誰知
點得	怎麼行
點都得	怎樣都行
點都好	無論如何
點都唔得	怎樣都不行
點都要	怎麼都要
點解	為什麼
點攪㗎	怎麼搞的
點講	怎麼說
點講都	無論如何
點講都好	無論如何
點估到	不料
點鬼樣	怎樣？
點係	不敢當
點係呀	不敢當
點可以	怎麼可以
點好	怎麼辦
點好呢	怎樣才好
點知	不料
點止	何止
點做	怎樣去做
點呢	怎麼辦呢
…點賣？	…多少錢？
點賣	多少錢
點脈	點穴
點生晒	瞎指揮
點心	小吃
點醒	指點
點豉油	蘸醬油
點先算…	什麼才是…？
點少得	怎麼少得了
點算	怎麼辦
點算好	怎麼辦才好
點睇	怎麼看
點話點好	怎麼都可以
點會	怎麼會
點樣	怎樣
玷	碰
掂	妥當
掂	直
掂筆甩	筆直
掂檔	搞定了
掂過碌蔗	事情進展很順利
掂過條蔗	非常順利
掂路	直路
掂紋	豎紋
掂晒	全都辦妥了
癲癲廢廢	傻裡傻氣
癲狗	瘋狗
癲佬	瘋子
癲婆	瘋子
捵	打滾
捵床捵席	滿床打滾
捵地	在地上打滾
捵嚟捵去	滾來滾去
電親	觸電
電單車	摩托車
電燈杉	電桿
電燈膽	電燈泡
電燈掣	電燈開關
電燈總掣	電燈總開關
電動拂蛋器	電動打蛋器
電飯煲	電飯鍋
電髮	燙髮
電風扇	電扇
電結他	電吉他
電焗爐	電烤箱
電瓜	觸電致死
電器舖	電器店
電腦	電腦
電芯	電池
電水煲	電熱水瓶
電水壺	電熱水瓶
電船	汽船
電梯	自動扶梯
電燙斗	電熨斗
電筒	手電筒
電話講緊	電話佔線
電話咭	電話卡
電話冇人聽	電話沒人接
電油	汽油
電熱水壺	電熱水瓶
丁咁多	一丁點兒
丁香	嬌小玲瓏
定	當然
頂	撐
頂包	冒名頂替
頂得住	撐得住
頂檔	頂替
頂更	替別人的班
頂夾	頭髮夾子
頂頸	拌嘴
頂吓肚	點補點補
頂住	撐著
頂住檔	頂替一下
頂籠	到頭
頂籠	滿
頂唔住	受不了
頂唔順	受不了
頂硬上	硬撐
頂心杉	眼中釘
頂心頂肺	窩心
頂肚	充飢
頂肚餓	充飢
椗	核
定	決定
定	穩
定	還是
定必	必定
定啲	鎮定一點
定啲嚟	穩住
定點	小數點
定當	穩
定過抬油	鎮定自若
定係	還是
定銀	定錢
定晒形	愣住了
定生死	決定成敗
定性	穩重
碟	盤子
疊埋心水	專心一意
蝶式	蝶泳
碟頭飯	蓋飯
啲啲咁多	一點點
啲咁多	一點點
啲咁多之嘛	一點點罷了
跌	丟
跌崩頭	摔破頭
跌親	摔倒
跌低	跌倒
跌低揦翻拃沙	不認失敗
跌到七彩	摔得暈頭轉向
跌價	降價
跌跤	摔跤
跌咗	丟了
跌爛	摔破
跌落	掉下
跌落地	落地
跌落地都要揦翻拃沙	不認失敗
跌落去	掉下去
跌落嚟	掉下來
跌失	丟失
丟低	丟下
丟架	丟人
刁僑扭擰	調皮
刁蠻	蠻不講理
丟那媽	他媽的
吊頸	上吊
吊靴鬼	胡攪蠻纏的人
吊鐘	吊鐘花
吊鐘	小舌
吊味	調味
吊癮	吊胃口
釣魚	打瞌睡
吊吊揈	悠蕩
調	調子
調更	調班
調位	換位
多得	多虧
多得晒	多有承惠
…多啲	多…一點
多啲	多一點
多啲人	更多人
多多	多
多多聲	多了
多句嘴	多說一句話
多過龍	太多了
多過頭	太多
多口	多嘴
多謝	謝謝
多謝晒	很感謝
多謝喎	謝謝了
多羅羅	多多的
多士	烤麵包
多士爐	烤麵包機
多少	一些
多少少	多一點
多數	大部分
多一事長一智	經一事長一智
朵	化名
墮	垂
惰	墜
惰角	偏僻
惰角地方	偏僻的地方
惰落	墜下
墮落嚟	墜下來
惰落嚟	墜下來
袋	口袋
袋	裝入袋內
袋好	放好
袋住	收下
袋	袋子
度	想
度	走
度	量
度錯	量錯
度吓	想想
度吓	走來走去
度吓	量量
度劇本	寫劇本
度橋	想法子
度嚟度去	想來想去
度身	量身
度身訂造	量身訂做
度水	借錢
度叔	小氣鬼
度位	量地方
當差	當警察
當更	值班
當黑	倒霉
當造	當季
當住	當著
當住佢講	當著他的面說
當衰	倒霉
當堂	當場
當堂甩鬚	當場出醜
當日更	值日班
當夜	值夜班
當夜更	值夜班
檔	攤子
檔口	攤子
當齋噏	當耳邊風
檔期	時間
當佢冇到	不放在眼裡
當佢冇嚟	管它
當佢透明	視若無人
當…冇到	當…不在
當冇嚟	掉以輕心
當冇嘢	當沒事
當食生菜	易如反掌
檔位	攤位
蕩失	迷路
蕩失路	迷路
刀	刀子
都	也
都似	有可能
都得	也行
…都假啦	…也是白搭
都幾好	還可以
都係	也是
都係噉	老樣子
都係唔	還是不
都好嘅	也好
刀仔	小刀
刀仔鋸大樹	以小博大
刀嘴	刀尖
刀字邊	立刀旁
都唔錯	還不錯
…都唔得	…都不行
都未	還沒
都未知	還不知道
…都有嘅	怎麼能…
…到	…到了
度	左右
艔	渡船
賭波	賭球
倒出嚟	倒出來
賭檔	賭攤
賭棍	指靠賭錢騙人為生的人
倒後鏡	後視鏡
賭仔	賭徒
倒竈	幫倒忙
倒冧	倒塌
倒米	闖禍
倒米壽星	搗亂的人
倒米壽星公	搗亂的人
倒模	鑄模
倒瀉	傾倒
倒瀉籮蟹	亂了套
倒屎塔	倒馬桶
倒樹蔥	倒立
…到	…得
到埗	抵達
…到飛起	非常…
…到夠	…個夠
…到極	…極了
到嗰陣	到時候
…到鬼噉	…得要命
…到衡	大肆…
到喉唔到肺	不夠
到喉唔到肺	沒吃夠
…到正	…個正著
倒及	下巴前突
倒及牙	倒口牙
到其時	到時候
…到唔恨	…透了
…到冇朋友	…極了
…到死	…極了
…到死死吓	…得半死
到時	到時候
到時到候	到時候
到時睇吓點先	到時候再說
倒褪	退後
…到貼地	…到極點
到而家	到現在
度	扇
度	這兒
度度	處處
度假屋	別墅
道行	本領
度數	分寸
道友	癮君子
督	戳
篤	底
督爆	戳穿
篤鼻	礙眼
篤波	桌球
督背脊	背地裡傷人
督親	戳傷
督穿	捅破
督穿個窿	捅個窿
篤底	底下的
篤灰	告密
篤眼篤鼻	礙眼
讀大學	上大學
獨係	只是
讀中學	上中學
讀寫困難	失讀症
獨睡	單人床
獨市生意	獨家生意
獨食	獨吃
讀小學	上小學
讀書	唸書
冬	冬至
東便	東邊
冬大過年	過冬至節比過年還重要
冬菇	香菇
冬瓜豆腐	三長兩短
東主	東家
冬甩	甜甜圈
冬蓉酥	老婆餅
凍	冷
凍冰冰	冷冰冰
凍茶	冰茶
凍親	著涼
凍到冇朋友	非常冷
凍到死	冷死了
凍到揗揗震	冷得直打哆嗦
凍啡	冷咖啡
凍滾水	涼開水
凍過水	沒命了
凍檸茶	冷檸檬茶
凍檸樂	凍檸檬可樂
凍水	冷水
凍水散瘀	冷水消腫
凍飲	冷飲
凍鴛鴦	冷咖啡茶
凍鴛鴦茶	冷咖啡茶
戙	摞
戙	豎
動粗	動武
戙篤	站著
戙篤企	垂直豎立著
戙篤笑	單口相聲
戙篤笑騷	單口相聲表演
戙腳	豎腿
戙起床板	熬夜
戙起隻腳	支起腿
戙企	垂直豎立著
短砵	短靴
短切切	很短
短度闊封	矮而胖
短法包	短法國麵包
短火	手槍
短踭	暗算
短裙	裙子
短褸	外套
短訊	短信
斷	論
斷斤賣	論斤賣
斷估	瞎猜
斷隻賣	論個兒賣
斷…賣	論…賣
𡁯	噘
𡁯長個嘴	噘嘴
𡁯起個嘴	噘著嘴
AA制	各付各的
A貨	假貨
M	月經
M巾	衛生巾
安哥	加演
花多眼亂	眼花繚亂
花檔	花店
花弗	誇耀
花款	花樣
花假	虛假的
花街	花卉市場
花膠	魚肚
花墟	花卉市場
花紅	紅利
花樽	花瓶
花旗	美國的
花旗參	西洋參
花冧	花蕾
花柳	梅毒
花柳病	梅毒
花利	小費
花僆	年輕小伙子
花僆仔	年輕小伙子
花僆女	年輕小姑娘
花哩花碌	花裡胡哨
花哩碌	花裡胡哨
花哩胡碌	花裡胡哨
花令	拘捕令
花令紙	拘捕令
花尾艔	渡船
花名	外號
花奶	淡奶
花棯	番石榴
花舖	花店
花灑	噴頭
花心	愛情不專一
花心大少	貪色的年輕闊少
花心蘿蔔	花花公子
花臣	式樣
花生騷	時裝表演
花生糖	花生仁兒糖塊兒
花生肉	花生米
花手巾	鬥魚
花市	花卉市場
花士令	凡士林
花城	廣州別稱
花廳	監獄
花王	園丁
化	開通
化灰都認得	認得出來
化骨龍	孩子
化學	質量差
化算	划算
快勞	文檔
快脆	快
快啲行喇	快點走吧
快啲好翻	早日康復
快啲啦！	快點吧！
快啲	快一點
快快脆	快快
快快脆脆	快快
快高長大	快快長大成人
快過打針	極快
快馬	快
快馬啲	快點
塊面紅紅哋	臉紅紅的
快手	快
快手啲	快點
快手快腳	迅速
拂	打
拂蛋	打蛋
拂蛋器	打蛋器
拂雞蛋	攪和雞蛋
拂水蛋	蛋羹
翻	回
番鴨	旱鴨
翻版	盜版
翻抄	再制
翻草	反芻
翻到	回到
翻房	回房間
翻房瞓	回房間睡覺
翻風	颳風
翻風落雨	颳風下雨
番梘	肥皂
番梘泡	肥皂泡
番狗	哈巴狗
翻工	上班
翻公司	回公司
番瓜	南瓜
番鬼	蠻不講理
番鬼	西洋的
番鬼仔	西洋小孩
番鬼佬	西洋人
番鬼佬涼茶	啤酒
番鬼妹	外國少女
番鬼婆	外國婦女
翻去	回去
翻鄉下	回鄉下
翻學	上學
翻轉頭	回頭
翻轉頭再嚟	回頭再來
番茄	番茄
翻企	回家
翻嚟	回來
翻唔切	趕不回來
翻唔到去	回不到
翻唔到轉頭	回不了頭
翻面	翻臉
翻屋企	回家
翻晒面	翻臉
翻生	復活
番薯	地瓜
番薯糖	糖水白薯
番攤	搖攤
翻頭嫁	再嫁
番話	外語
番芫茜	香芹
反	開玩笑
犯	犯人
反斜棟	反斜線
反斗	頑皮
反斗星	調皮蛋
反瞓	睡不安穩
反骨	反叛
反骨仔	叛徒
反骨無情	忘恩負義
反口	反悔
反口覆舌	不認前賬
反咗肚	死了
反面	翻臉
反面唔認人	翻臉不認人
反眼	翻白眼
反肚	死
反為	反而
反胃	噁心
反應唔切	來不及反應
煩到死	煩死了
凡係	凡是
犯	招惹
飯煲	飯鍋
飯鏟	鍋鏟
飯鏟頭	眼睛蛇
飯腳	剩飯底子
飯蓋	鍋蓋
飯盒	盒飯
飯殼	飯勺
飯焦	鍋巴
犯眾憎	犯眾怒
飯餸	飯菜
飯廳	食堂
飯枱	餐桌
飯湯	米湯
飯堂	食堂
發白日夢	做白日夢
法包	法國麵包
發青光	青光眼
發錢寒	財迷心竅
發達	發財
發癲	發瘋
發花癲	發瘋
發火	發脾氣
發風	痲瘋病
髮夾	頭髮夾子
發雞盲	患夜盲症
發雞瘟	發瘋
發驚青	慌張
髮腳	髮邊
發過豬頭	發大財
法國鬼	法國人
發光	發亮
發吓姣氣	抖抖威風
發姣	賣俏
發㷫	發怒
發㷫	發燒
發開口夢	說夢話
發仔寒	渴望生兒子
發酒癲	發酒瘋
發咗一個夢	做了一個夢
髮箍	髮帶
發窮惡	撒野
發爛渣	撒野
發冷	打擺子
發狼戾	撒野
髮廊	理髮店
發老姣	灌米湯
發老脾	發火
發老婆寒	渴望娶老婆
發茅	撒野
發𤷪𤺧	發火
髮尾	髮梢
發毛	長霉
發木獨	發愣
發夢	做夢
發夢都未見過	做夢也沒有見過
發嬲	生氣
發牙痕	多嘴
發喑話	說夢話
發噏瘋	胡扯
發吽哣	發愣
發惡	發火兒
發噩夢	做惡夢
發泡膠	泡沫塑料
發泡膠盒	發泡塑料盒兒
發晒老脾	發脾氣
發細路哥脾氣	耍小孩子脾氣
發神經	神經病
發市	開市
發燒友	狂熱者
發書寒	渴望看書
發圍	突圍
發瘟	發瘋
發瘟雞	傻子
發羊吊	癲癇
髮型屋	理髮店
發熱絲	發熱器
發軟蹄	腿軟
揮春	春聯
廢	無能
廢	窩囊
肺	肺臟
廢柴	廢物
費鬼事睬你	不理你啦！
費事	懶得
費事	麻煩
費事理	懶得去管
費事話	懶得說
廢話少講	廢話少說
廢人	無用的人
分分鐘	隨時
分豬肉	人人有份
分唔開	分不開
婚紗舖	婚紗店
分身家	分財產
粉	海洛因
粉	粉條
粉	麵糊
粉筆擦	板擦
粉筆灰	粉筆末
粉刷	板擦
粉擦	板擦
粉腸	小腸
粉腸	笨蛋
粉竇	吸食毒品的場所
粉檔	販賣毒品的場所
粉仔	吸毒的年輕人
粉絲	米粉
粉友	吸白粉的人
瞓	睡
瞓低	躺下
瞓得	能睡
瞓得好	睡得好
瞓得好淰	睡得很熟
瞓得唔好	睡得不熟
瞓得唔淰	睡得不熟
瞓得安樂	睡得安穩
瞓地	睡地上
瞓地下	睡地上
瞓多陣	多睡一會兒
瞓到鋸鋸聲	睡得熟
瞓到淰晒	睡得很熟
瞓到黃朝百晏	睡過頭
瞓街	露宿街頭
瞓覺	睡覺
瞓覺覺豬	睡覺覺
瞓個靚覺	睡個舒服覺
瞓過龍	睡過頭
瞓陣	睡一會兒
瞓著	睡著
瞓著覺	睡著
瞓著咗	睡著了
瞓戾頸	落枕
瞓落	睡著
瞓唔到	睡不著
瞓唔著	睡不著
瞓唔著覺	睡不了
瞓唔落	睡不著
瞓晏覺	睡午覺
瞓晒身落去	全力投入去幹
瞓衫	睡衣
瞓身	全力
瞓身搏盡	盡全力
瞓醒	睡醒
瞓醒覺	睡醒
忿氣	服氣
忿老	服老
…份人	這人
份人	為人
忽	小塊
忽	處
忽得	毒品
忽得仔	吸毒少年
忽得妹	吸毒少女
忽忽得得	迷迷糊糊
罰	處罰
佛都有火	誰也受不了
罰企	罰站
foul	淘汰
否	淘汰
foul出局	淘汰出局
否出局	淘汰出局
浮	輕浮
埠	港口
埠仔	偏僻的地方或郊區
埠頭	外國商埠
啡	咖啡
飛站	過站而不停
啡走	咖啡加奶不加糖
啡色	咖啡色
啡	刺
啡	噴射
啡啡聲	嘶嘶響
啡水	噴水
飛	理
飛	票
飛邊	切去麵包皮的三明治
飛邊	去邊
飛翔船	氣墊船
飛碟	飛盤
飛髮	剪頭髮
飛髮佬	理髮師
飛髮舖	理髮店
飛機仔	小飛機
飛機裇	夾克
飛機師	機長
飛機銻	鋁合金
飛起	拋棄
飛起	非常
飛仔	阿飛
飛螆	口瘡
飛咗	吹了
非禮	耍流氓
非禮罪	猥褻侵犯
菲林	軟片
飛尾	票根
飛女	女流氓
飛沙走奶	不加奶
飛水	涮
非常之	非常
非常之重要	非常重要
非士	面子
飛士	面子
飛數	面部美容
飛鼠	蝙蝠
飛躍道	跑酷
飛翼	白色有翅母蟻
飛翼船	氣墊船
肥	不合格
肥	胖
肥腯腯	胖乎乎
肥嘟嘟	胖胖的
肥肥白白	白白胖胖
肥膏	脂肪
肥過頭	太胖了
肥仔	小胖子
肥仔米	爆米花
肥仔嘜	胖小子
肥咗	胖了
肥佬	胖子
肥佬	落榜
肥妹	胖姑娘
肥𥹉	油膩黏手
肥婆	胖女子
肥瘦	胖瘦
肥屍大隻	肥胖
肥揗揗	胖乎乎
肥田料	化肥
肥肚腩	大肚子
friend	朋友
friend過打band	很要好的朋友
粉絲	歌迷
fax	傳真
fee士	抓毛絨
fee哩啡咧	哭
揈	甩
揈頭	搖頭
揈頭丸	搖頭丸
弗	標緻
弗到漏油	非常的標緻
feel	感覺
灰士	保險絲
科文	領班
火車飛	火車票
火車卡	車廂
火機	打火機
伙記	店員
火頸	脾氣暴躁
火滾	惱火
火起	發火
火氣	脾氣
火氣唔係幾好	脾氣不怎麼好
火紅火綠	大怒
火酒	酒精
火遮眼	發大火
火燭	火警
火燭車	消防車
火燭喇	著火啦！
火𤓓	煙味
火𤓓𡃴	煙味
火尾	火舌
火腩	燒豬
火牛	變壓器
火水	煤油
火水燈	煤油燈
火水爐	煤油爐
火屎	火星
火太猛	火太旺
伙頭	廚師
伙頭軍	廚師
伙頭仔	廚師的幫手
火油	煤油
貨不對辦	貨物與樣品不符
貨車	卡車
貨櫃	集裝箱
貨櫃車	集裝廂車
貨櫃碼頭	集裝箱碼頭
貨仔	貨色
貨卡	貨車板
貨𨋢	貨運電梯
課室	教室
貨van	小巴
慌	怕
方包	白麵包
坊間	市面上
慌怕	怕
慌晒	驚慌
慌失失	慌手慌腳
房	室
房車	轎車
房中房	分間樓宇單位
放大假	放長假
放膽	放心
放膽去	放心去
放膽做	放心做
放低	放下
放電	賣俏
放飛機	放鴿子
放飛劍	吐痰
放飛蚊	打哈欠
放監	出獄
放狗	遛狗
放工	下班
放貴利	放高利貸
放喺	放在
放喺地下	放在地上
放紙鷂	放風箏
放唔低	放不下
放馬過嚟	盡管出招吧
放䠋	放棄
放盤	發售
放盤廣告	發售廣告
放生電	賣俏
放蛇	設陷阱
放數	放高利貸
放葫蘆	吹牛
放入櫃桶	放進抽屜
放煙花	放煙火
虎	老虎
苦刁刁	非常苦
苦瓜噉嘅面	苦著臉
苦瓜噉口面	苦著臉
苦瓜噉面	苦著臉
苦瓜乾	愁眉苦臉的人
苦瓜乾噉口面	苦著臉
苦瓜面	苦著臉
苦過弟弟	苦不堪言
苦口苦面	愁眉苦臉
褲	褲子
褲帶	皮帶
褲袋	褲兜
副檔名	擴展名
褲腳	褲腿
負氣	滿腹牢騷
負氣袋	滿腹牢騷的人
褲浪	褲襠
富太	貴婦
褲頭	褲腰
褲頭帶	褲帶
符	辦法
符弗	辦法
輔助輪	輔助輪
輔助轆	輔助輪
灰	灰心
灰佬	奸細
灰水	石灰水
晦氣星	倒霉鬼
覆電話	回電話
覆機	回電話
蝠鼠	蝙蝠
福頭	笨蛋
服	服氣
歡喜	喜歡
款	樣式
封包	紅封
風槍	氣槍
風腸	臘腸
蜂竇	蜂巢
風褸	風衣
風流	出風頭
風流	閒情逸致
風栗	栗子
風爐	小爐子
風赧	風團
風生水起	活躍
風水輪流轉	三十年河東
風水佬	陰陽先生
風水生	堪輿家
風水佬呃你十年八年	我不會騙你的
風水尾	敗家子
風扇	電風扇
風頭躉	愛出風頭的人
風頭火勢	正在火頭上
風筒	吹風機
烽煙節目	叩應節目
逢親	凡是
逢人憎	人人討厭
鳳	妓女
鳳爪	雞爪子
鳳姐	妓女
奉旨	決
奉旨唔	決不
鳳樓	妓女居處
闊	寬
闊褲腳	肥褲腿
闊窄	寬窄
闊落	寬暢
闊佬	闊氣
闊佬懶理	甩手不管
闊太	有錢的婦女
加把口	插嘴
加菜	加餐
家嘈屋閉	家無寧日
家居環境	居住環境
家公	公公
家下	現在
家陣	現在
家姐	大姐
嘉𩶘	鯛魚
加埋	加上
家婆	婆婆
家山	祖墳
家山發	走好運
家山有眼	祖宗有靈
傢俬	傢俱
傢俬舖	家具店
家嫂	媳婦
加餸	加菜
家頭細務	家務
家庭計劃	計劃生育
加人工	加薪
家爺仔乸	全家人
家用	家裡的開支
假膊	墊肩
假飛	假票
假假哋	總算
假假哋都係	總還是
㗎	的
架步	色情場所
駕步	架勢
架罉	工具
架車死咗火	車子拋錨了
價錢相宜	價錢便宜
咖啡漬	咖啡的污跡
咖啡廊	咖啡廳
㗎咋	而已
㗎喇	的
㗎啦	嗎
咖喱魚蛋	咖喱魚丸
嫁唔出	嫁不出去
嫁女餅	喜餅
家生	工具
架勢	威風
㗎仔	日本少男
㗎佬	日本人
㗎文	日文
㗎妹	日本少女
㗎頭	日本人
㗎話	日語
街邊	馬路邊
街艔	擺渡
街坊	鄰居
街坊鬼鬼	老鄰居
街口	路口
街喉	消防栓
街井	消防栓
街知巷聞	家喻戶曉
階磚	方塊
階磚	方磚
階磚仔	馬賽克
街市	菜市場
街市仔	菜市小販
街市佬	菜市小販
街數	債務
皆因	全因為
解	解釋
解簽	拆簽
解究	究竟
解纈	解開結
解夢	圓夢
解釋唔到	無法解釋
解畫	旁白
界	界線
鎅	鋸
鎅板	把木材鋸成板子
鎅崩手	割破手
鎅親	刮破
鎅刀	割紙刀
鎅花	刮出一點痕跡
解犯	押送犯人
介乎	介於
解款	運鈔
解款車	運鈔車
解款員	押運員
戒口	忌口
芥醬	芥末醬
介子	墊圈
鎅紙	裁紙
鎅紙刀	割紙刀
芥蘭	甘藍菜
芥辣	芥末
戒甩	戒掉
戒唔甩	戒不掉
戒奶	斷奶
戒甜	禁食甜品
格	格子
隔	濾
隔	距離
𠺝	…嘛
格價	比價
隔渣	過濾渣滓
格仔	格子
格仔餅	格子鬆餅
格仔紙	方格紙
格仔裙	花格裙子
格仔裇	花格襯衫
隔咗咁耐	這麼久了
胳肋底	腋下
胳肋底毛	腋毛
隔籬	隔壁
隔籬飯香	外國的月亮比較圓
隔籬房	隔壁房間
隔籬左近	旁邊不遠的地方
隔籬鄰舍	鄰居
隔籬屋	隔壁鄰居
隔山買牛	瞎碰
隔成條墟咁遠	離得遠
離天隔丈遠	離得遠
隔夜	隔了一夜的
隔夜茶	隔了一夜的茶
隔夜茶唔飲得	隔了一夜的茶不能喝
隔夜飯	剩飯
隔夜仇	很小的嫌隙
隔夜餸	剩菜
監	強迫
監倉	監獄
監粗	硬幹
監躉	囚犯
監犯	囚犯
監人賴厚	強人所難
減	撥
減筆	縮寫
減筆字	簡體字
減價	降價
監	趁著
監生	活活
監生打死	活活打死
監生激死	活活氣死
監生埋	活埋
監生壅	活埋
監生食	生著吃
監熱食	熱著吃
奸	壞
奸狡	狡猾
奸角	反派
奸賴	賴皮
奸貓	賴皮
揀	選
梘	肥皂
簡筆字	簡體字
梘粉	洗衣粉
簡簡單單	很簡單
梘盒	肥皂盒
揀擇	挑選
簡直係	簡直是
梘片	肥皂片
揀飲擇食	挑吃
梘液	肥皂液
橺	隔
間	畫直線
間尺	尺子
間花腩	五花肉
橺房	打隔斷
間格	格子
間中	偶爾
間唔中	有時
間條	條紋
間條衫	條紋上衣
間條裇衫	條紋襯衫
橺一間房	隔出一個房間來
更	班
耕田佬	莊稼人
浭	涉
浭過河	涉水過河
浭水	涉水
夾	夾子
夾	湊
夾	與
挾	搛
夾板	膠合板
夾band	組樂團
夾錢	湊錢
夾錢送禮	湊份子
夾檔	合作
夾份	合伙
夾份送禮	湊份子
夾計	串通
夾歌	合唱
夾口供	串通口供
夾口型	假唱
夾住	夾著
夾埋	合起來
夾埋一齊去	搭伙一塊兒去
夾埋有幾多？	湊起來有多少？
夾萬	保險箱
夾衲	夾衣
夾硬	硬著
夾硬迫入去	硬著擠進去
夾硬要佢去	硬是要他去
夾手	緊密配合
夾手夾腳	互相配合
挾餸	夾菜
曱甴	蟑螂
曱甴屎	雀斑
交	打架
膠	橡膠
膠布	創可貼
膠杯	塑料杯
膠叉	塑料叉子
膠擦	橡皮擦
交帶	吩咐
交帶落	吩咐
交低	交待
膠凳	塑料椅子
膠碟	塑料碟子
膠袋	塑料袋
膠刀	塑料刀子
膠花	塑料花
交更	交班
交吉	交空房子
膠公仔	塑料娃娃
交關	厲害
膠盒	塑料盒子
膠喉	膠管子
交行貨啫	只是一般的水平
膠樽	塑料瓶
膠紙	膠帶
交租	交房租
膠箍	橡皮筋
膠眼鏡	塑料眼鏡
膠鴨仔	橡皮鴨
茭筍	茭白
膠絲	尼龍絲
膠繩	尼龍繩
膠拖	橡皮拖鞋
膠枱布	塑料桌布
膠套	塑料袋子
膠通	塑料管
膠桶	塑料桶
攪	搞
攪邊科呀	搞什麼鬼？
攪場大龍鳳	鬧事
攪錯	弄錯
攪得掂	辦得到
攪掂	行
攪掂	辦好
攪掂晒	一切都辦好了
攪到	搞得
攪到七個一皮	弄得手忙腳亂
攪到雞毛鴨血	弄得雞犬不寧
攪到咁大劑	弄得這麼嚴重
攪到咁大鑊	弄得這麼嚴重
攪到立立亂	搞得亂七八糟
攪到滿天神佛	都鬧翻天了
攪到烏喱單刀	弄得一塌糊塗
攪到一身潺	惹得許多麻煩
攪花臣	搞花樣
攪風攪雨	興風作浪
攪攪震	搗亂
攪攪新意思	弄一些噱頭
攪gag	搞笑
攪鬼	搗亂
攪喊	弄哭
攪作	搞
攪珠	抽籤
攪佢唔掂	拿他沒辦法
攪爛gag	講冷笑話
攪亂檔	裹亂
攪唔掂	辦不到
攪派對	搞派對
攪三攪四	拈花惹草
攪手	主辦人
攪衰	弄壞
攪屎棍	刺兒頭
攪事	鬧事
攪成噉	弄成這樣
攪笑	好笑
攪笑	逗笑
攪妥	辦好
攪勻	拌勻
攪和	扯平
攪𢰸	弄壞
攪嘢	搞笑
攪瘀	搞糟
較	調節
鉸	合頁
骹	骨關節
鉸剪	剪刀
鉸剪手	剪刀手
較早前	早前
較早時	早前
較鐘	對錶
校味	調味
較味	烹調食物的時候加上調料調味
校啱	調到正確
校啱時間	調準時間
校色	調色
校線	定弦兒
覺覺豬	睡覺
雞	哨子
雞	妓女
雞	扳機
雞包	雞肉包
雞髀	雞腿
雞春	雞蛋
雞春孳	母雞腹內未成形的小蛋
雞腸	天書
雞蟲	嫖客
雞蛋仔	雞蛋糕
雞蛋糖水	雞蛋甜湯
雞啄唔斷	說話沒個完
雞噉腳	走得快
雞頸	雞脖子
雞腳	把柄
雞腳	雞爪子
雞公	公雞
雞關	雞冠子
雞項	小母雞
雞紅	雞血
雞仔	小雞
雞螆	雞蝨
雞球大包	肉包子
雞柳	雞菲力
雞僆	小雞
雞盲	夜盲症
雞尾	雞屁股
雞毛鴨血	雞犬不寧
雞毛掃	雞毛撢子
雞乸	母雞
雞乸咁大隻字	斗那麼大的字
雞扒	雞排
雞泡魚	河豚
雞腎	雞胗
雞手鴨腳	毛手毛腳
雞屎果	番石榴
雞頭	挖土機
雞同鴨講	說不通
雞翼	雞翅膀
偈	內燃機
偈	話
計	辦法
計仔	辦法
偈油	機油
計	算
計清楚	算清楚
計帶	計較
計掂	算好了
計掂	算好
計翻條數	算起來
計吓	算算
計吓條數	算算帳
計起上嚟	算起來
計正	按理說
計落	算起來
計唔清	數不清
計唔掂	算不清
計埋	把那些都算上
計你話	依你說
計我話	依我看
計晒	都算完了
計數	計算
計數機	計算器
計條數	算一算
今	這
金啤梨	小紅莓
今次	這次
金錢菇	金針菇
今屆	本屆
金桔	金柑
金句	警句
金腳帶	金環蛇
今個禮拜	這個星期
今個月	這個月
今個月尾	這個月底
金菇	金針菇
金菇菜	金針菇
金龜婿	有錢有地位的女婿
金針	黃花菜
金針菜	黃花菜
今朝	今天早上
金豬	烤豬
金撈	金勞力士錶
今晚黑	今天晚上
金鈪	金鐲
金銀紙	紙錢
今鋪	這次
金舖	金店
金山	美洲
金山阿伯	華僑
金山伯	華僑
金山客	華僑
今世	今生
今生今世	這輩子
金手指	背地裡傷人
甘筍	紅蘿蔔
甘筍仔	小紅蘿蔔
甘筍汁	紅蘿蔔汁
今時今日	現在
今時唔同往日	今非昔比
今勻	這次
今回	這次
今日	今天
今日好凍	今天很冷
…噉	…的樣子
噉	那麼
噉點呀？	又怎麼樣？
噉都得	怎麼可以這樣
噉都得嘅？	這樣還成？
噉都好	這樣子也好
噉都唔得	這樣還不行嗎
噉都唔得咩	難道這樣還不行嗎
…噉款	…的樣子
…噉解	這就是為什麼…
…噉嘅款	…的樣子
…噉嘅頭	…似的
噉就弊	這樣就糟糕了
噉就啱	這樣就對了
噉即唔係	那就不是
噉做	這麼做
噉仲得掂	這還了得
噉唔係	可不是嗎
…噉頭	…似的
…噉頭	…的樣子
…噉頭	像…似的
噉又得	怎麼可以這樣
噉又點	那又怎樣？
噉又點呀？	那又怎樣？
噉又係	那倒是
噉又唔係	那倒不是
噉又唔係噃	那倒不是的
噉又唔同	那就不同
噉樣	這樣
咁	這麼
咁遲先嚟	這麼晚才來
咁串	趾高氣揚
咁大個	這麼大了
咁大個都唔化	這麼大了還食古不化
咁大個仔	這麼大了
咁大個女	這麼大了
咁大個人	這麼大了
咁多年	這麼多年
咁多位	各位
咁嘅嘢	這種事
咁高咁大	差不多
咁鬼…	怪…的
咁鬼死…	怪…的
咁好口	嘴巴很甜
咁好死	那麼好
咁盞	有這等好事
咁滯	快要
咁盡	很過份
咁盡	那麼絕
禁止標貼	禁止張貼
咁盟塞	不開竅
咁啱	那麼巧
咁啱嘅	怎麼這麼湊巧
咁晏	這麼晚
咁上緊	左右
咁上下	左右
撳	按
撳錢	提款
撳錯掣	按錯電鈕
撳釘	圖釘
撳機	提款
撳掣	按電鈕
撳鐘	按門鈴
撳唥鐘	摁電鈴
撳𨋢	按電梯
撳落去	按下去
撳門鐘	按門鈴
跟	處理
跟	跟隨
跟大隊	隨大溜
跟得切	跟得上
跟到實	跟隨
跟風	跟潮流
跟進	接著處理
跟住	接著
跟住落嚟	接下來
跟尾	尾隨
跟尾狗	跟屁蟲
跟眼	幫忙看管
跟實	緊跟
跟手	順手
跟手尾	完成
跟手閂門	隨手關門
跟人口水溦	學舌
…緊	…著
緊要	要緊
緊要事	重要事情
近住	靠近
近排	最近
羹	湯匙
梗	當然
梗板	死板
梗頸	牛脾氣
梗係	當然
梗係啦	當然是了
急不及待	迫不及待
急到氹氹轉	急得團團轉
急凍	冷凍
急凍食品	冷凍食品
急急腳	急急忙忙地
急急腳去	匆匆趕去
蛤𧊅	青蛙
急口令	繞口令
急症室	急診室
蛤乸	田雞
蛤乸衣	工作褲
急尿	憋尿
急屎	憋著大便
鴿	鴿子
䀹	盯
䀹緊	死命盯著
䀹住	監視
䀹住佢	盯死他
䀹實	盯死
䀹水	望風
䀹嘢	偷窺
吉	空
拮	扎
桔	橘子
拮親	扎破
拮親手	扎破了手
吉車	空車
拮出血	刺到出血
拮穿	扎破
吉屋	空房子
吉屋招租	空房出租
吉身	空身
吉手	空手
吉士	膽量
拮肉	扎人
趷	瘸腿
趷跛跛	單腳跳
趷腳	瘸腿
趷吓趷吓	一瘸一拐
吃口吃舌	結結巴巴
趷起	翹起
趷起身	欠起身
趷起手指公	翹起大拇指
趷起條尾	翹起尾巴
趷路	滾蛋
久不久	偶爾
狗帶	項圈
九大簋	盛宴
狗竇	狗窩
九個字	四十五分鐘
狗公	公狗
九毫九	九毛九分
狗血淋頭	狗血噴頭
狗爪邊	犬部
狗仔	傢伙
狗仔	小狗
狗仔粉	擔仔麵
狗仔式	狗爬式
九曲十三彎	彎彎曲曲
九唔搭八	牛頭不對馬嘴
久唔久	不時
狗毛蟲	毛毛蟲
狗乸	母狗
狗牙	鋸齒狀的
狗牙邊	鋸齒邊
狗咬狗骨	窩裡鬥
狗蝨	跳蚤
韭黃	韭菜
九因歌	九九表
夠班	夠資格
夠秤	夠分量
夠膽	敢
夠膽死	敢做
救翻	救回
救翻	救回
夠格	有資格
夠薑	有種
究竟	到底
夠勁	帶勁
夠喉	夠
夠咗有突	夠了有餘
夠鐘	到點
夠鐘數	到時間了
夠quali	夠格
夠喇	夠了
夠老友	夠朋友
夠皮	夠本
夠晒	足夠了
夠晒…	…極了
夠晒皮	疲憊
救生水泡	救生圈
夠水頭	很有錢
夠時候咯	時間到了
夠數	夠
夠算	足夠
夠運	走運
夠有突	有餘
嚿	塊
舊底	從前
舊陣時	過去
舊曆	農曆
舊年	去年
舊時	從前
舊日	過去
gas爐	煤氣灶
嘅	呢
嘅	的
嘅時	的時候
嘅時候	的時候
嘅話	的話
嘅樣	的樣子
機	機會
基吧	同志酒吧
機械人	機器人
基佬	同性戀
基女	女同性戀
機舖	遊戲機店
機室	遊戲機店
機師	機長
基圍	堤壩
幾回	差點
機油	潤滑油
肌肉	肌肉
幾	挺
幾廿年	幾十年
幾襯你喎	很適合你
幾錢	多少錢
幾大	無論如何
幾大都	無論如何也
幾大都要	無論如何也要
幾大就幾大	豁出去了
幾大就幾大喇	豁出去了！
幾大就幾大，燒賣就燒賣	豁出去了，什麼也不管了，愛怎樣就怎樣，怎麼樣就怎麼樣
幾大	多大
幾大鑊	挺嚴重
幾得人驚	挺嚇人的
幾多	多少
幾多錢	多少錢
幾快	蠻快
幾咁	多
幾咁閒	無所謂
幾咁好	挺好的
幾過份	蠻過份
幾…吓	挺…的
幾何	稀罕
幾好	挺好
幾好吖嘛	挺好的吧
幾盡	很過份
幾難	好不容易
幾蚊雞	幾塊錢
幾難先至	好不容易才
幾耐	多久
幾平	蠻便宜
幾時	什麼時候
幾時幾日	何時何日
幾時係	哪裡是
幾時話	什麼時候說的
幾時話過	什麼時候說過
幾日	幾天
幾有型	真酷
幾遠	多遠
記低	記下來
記低晒	都抄下來了
記得起	想得起
記翻	想起
記翻起	想起了
記翻晒	記起來了
記掛	掛念
記起	想起
記招	記者會
記住	記著
記事簿	記事本
既然之	既然
記認	標記
忌廉	奶油
忌廉餅乾	奶油餅乾
忌廉芝士	奶油奶酪
忌廉梳打	奶油蘇打
忌廉威化餅	奶油維夫餅乾
技術總監	技術長
gag	笑話
驚	怕
驚青	慌張
驚青青	慌張
驚到標尿	嚇得屁滾尿流
驚到唔出得聲	嚇得說不出話來
驚到面青	嚇得臉色蒼白
驚到揗揗震	嚇得直打哆嗦
驚凍	怕冷
驚驚青青	慌張
驚住	擔心
猄皮	鹿皮
驚死	怕死
驚死…	生怕…
驚死考唔到	生怕考不上
頸	脖子
頸巾	圍巾
頸喉	喉嚨
頸喉痛	喉嚨痛
頸渴	口渴
頸鏈	項鏈
鏡	鏡子
鏡架	鏡框
儆錫	小心愛惜
鋸	鋸子
鋸頸	自刎
鋸牙	鋸齒
鋸扒	吃牛排
啹	順心
啹喀	廓爾喀
啹喀兵	廓爾喀軍
啹喀人	廓爾喀人
舉薦	推薦
句	句子
據講	據說
句鐘	小時
腳	腳
腳板	腳
腳板底	腳底
腳板堂	腳掌
腳痺	腳發麻
腳踏掣	腳煞
腳架	三角架
腳甲	腳趾甲
腳瓜	腿肚子
腳瓜眈	腿肚子
腳瓜瓤	腿肚子
腳骨	小腿
腳骨力	腿力
腳踭	腳跟
腳仔軟	腿軟了
腳掣	腳煞
腳枕	腳上的繭子
腳趾	腳趾頭
腳趾公	大腳趾
腳趾罅	腳趾縫
腳趾屘	腳小趾
腳面	腳背
腳毛	腿毛
腳鈪	腳鐲
腳眼	腳踝
腳坳	膕窩
腳線	腳板
腳肚	腿肚子
腳肚瓤	腿肚子
腳軟	腿軟
薑醋	豬腳薑
薑蓉	薑泥
嘰趷	梗阻
嘰嘰趷趷	結結巴巴的
嘰哩咕嚕	嘰嘰咕咕
戟	糕餅
激	氣
激親	惹惱
激凸	性感
激到爆	氣炸了
激到泵泵聲	氣壞了
激到彈起	勃然大怒
激到好嬲	氣壞了
激到扎扎跳	暴跳如雷
激到甩肺	氣壞了
激到眼火爆	氣炸了
激到死死吓	氣得要命
激鬼氣	真氣人
激氣	氣人
激㷫	激怒
激嘴	親嘴
激嬲	激怒
激奀	氣壞
激死	氣死
激死我	氣死我
激死人	氣死人
…極都有限	…不了多少
極之	非常
極其量	充其量
極力子	離合器
兼且	並且
兼隊	插隊
兼夾	而且
堅持落嚟	堅持下去
堅離地	脫離平民百姓
堅料	真實資料
見…	跟…見面
見步行步	走一步算一步
見點	感覺怎樣
見到	看到
見功	見效
見工	面試
見過鬼都怕黑	一朝被蛇咬
見過鬼就怕黑	一朝被蛇咬
見過鬼怕黑	一朝被蛇咬
見紅	流血
見真章	來真的
見周公	睡覺
見連丸	奎寧丸
見唔到	見不著
見牙唔見眼	笑瞇了眼
見使	耐花
見食	耐吃
見一步，行一步	走一步算一步，走一步看一步，摸著石頭過河
經紀	經紀人
矜貴	珍貴
京戲	京劇
經唔起考驗	經不起考驗
經已	已經
景	風景
景轟	蹊蹺
勁	好
勁	非常
勁抽	厲害
勁歌	帶勁的歌
勁悶	很無聊
喼	箱子
喼帽	鴨舌帽
劫	搶
劫	澀
挾	夾
挾親	夾住
挾腳	擠腳
結婚相	結婚照
結恭	便秘
結咗婚	結婚了
結他	吉他
結他手	吉他手
𠹳	倒霉
𠹳	稠
𠹳凸凸	稠稠的
𠹳粥	稠粥
𠹳撻撻	稠稠的
𠹳嘢	重大事情
嬌嗲	嬌
撟	擦
撟汗	擦汗
撟眼淚	擦眼淚
叫白車	叫救護車
叫雞	召妓
叫餸	點菜
叫餸食飯	點菜吃飯
叫糊	聽張
撬	挖
撬墻腳	挖牆腳
撬走	挖走
歌柄	話
哥基	柯基
哥基犬	柯基
哥記	老兄
哥仔	小哥
歌仔	歌
哥爾夫	高爾夫
哥爾夫球	高爾夫球
嗰	那
嗰便	那邊
嗰次	那次
嗰單畸士	那件事
嗰啲	那些
嗰啲嘢	那些東西
嗰度	那裡
嗰個	那個
嗰個係	那是
嗰個人	那個人
嗰個嘢	那傢伙
…嗰吓	…的時候
嗰陣	那時候
嗰陣時	那時候
嗰隻衰嘢	那個壞東西
嗰隻嘢	那傢伙
嗰種	那種
嗰輪	那陣子
嗰槓嘢	那些事兒
嗰晚	那晚
嗰排	那陣子
嗰時	那時候
嗰處	那邊
嗰頭	那邊
嗰條友	那個傢伙
嗰條友仔	那個小子
嗰位	那位
嗰一晚	那一夜
嗰日	那天
個噃	啦
個半	一塊半
個幾	一塊多錢
個個	每個
個個禮拜	每個星期
個零	一個多
個零鐘	一個多小時
個零銀錢	一塊多一點點
個囉	啦
個囉噃	了
個心好翳	心裡很煩悶
個心十五十六	心裡亂糟糟的
個肚有啲唔妥	肚子不舒服
個喎	啦
個樣好得戚	樣子很得意
哥哥仔	小兄弟
該煨	糟糕
改錯帶	塗改帶
改翻	改正
改轉	變換
改名	起名
蓋	蓋子
咯嗲	雞尾酒
覺	覺得
閣	閣樓
覺點	覺得怎麼樣
各花入各眼	情人眼裡出西施
各行各路	各走各的路
角仔	油角
閣仔	閣樓
角落頭	角落
覺眼	注意
覺眼	顯眼
各安天命	聽天由命
覺意	留意
肝	肝臟
乾炒牛河	乾炒牛肉米粉條
乾乾淨淨	很乾淨
乾爭爭	乾巴巴
乾鯁	乾噎
乾鯁鯁	乾巴巴
乾萌萌	乾巴巴
乾晒塘	手頭缺錢
乾濕褸	風雨衣
乾手淨腳	乾淨利落
乾瑤柱	乾貝
趕…扯	趕…走
趕扯	趕走
趕得切	來得及
趕工	加班
趕過嚟	趕過來
趕住去投胎咩	你沒長眼呀？
趕佢扯	趕他走
趕唔切	來不及
趕唔得切	來不及
趕時候	趕時間
趕頭趕命	拼命趕
趕人扯	把人攆走
缸	水缸
工廠妹	工廠女工
講開	說起
剛啱	剛好
江湖大佬	黑社會頭目
江湖佬	江湖客
江瑤柱	乾貝
講	說
講拜拜	告別
講白啲	坦白說
講畀…知	告訴…
講畀佢知	告訴他
講畀佢聽	告訴他
講畀我知	告訴我
講畀我聽	告訴我
講畀…聽	告訴…
講波	球賽評述
講波佬	足球解說員
港產片	港產電影
港燦	香港人
講出嚟	說出來
講錯嘢	說錯話
講粗口	說粗話
講粗口鬧人	說粗話罵人
講打講殺	動粗
講大話	撒謊
講得出做得到	說到做到
講得口響	說得好聽
講得啱	說得對
講掂	講妥
講定	說好
講多錯多	言多必失
講多無謂	多說無用
講多無謂，食多濕滯	多說無用，少說多做，少說為妙，少說為佳，少說空話多做實事
講到白	說得明白
講到白晒	說得明白
講到尾	說到底
講到明	表明
講到實牙實齒	說得板上釘釘的
講到天花龍鳳	說得天花亂墜
講到話	至於
港督	香港總督
講翻轉頭	話說回來
講法	說法
講假	說假話
講咁易咩	說倒是容易
講幾句說話	說幾句話
講句公道說話	說句公道話
講古	講故事
講古仔	講故事
講古佬	說書人
講鬼古	講鬼故事
講吓笑啫！	只是說笑而已啦
港客	來自香港的人
講口齒	講信用
講起	說起
講起上嚟	說起來
講起一匹布咁長	說來話長
講起又講	說起來
講開又講	說起來
講真	說實話
港姐	香港小姐
港紙	港幣
講中	說中
講中晒	全說中了
講爛口	說粗話
講漏嘴	說走了嘴
講嚟講去	說來說去
講嚟聽吓	說來聽聽
講落去	說下去
講唔出口	說不出口
講唔到	開不了口
港漫	香港漫畫
講咩	說什麼
講明	說明白
講三講四	說三道四
講生晒	老在說
講心嗰句	說真心話
講實	說定
講聲	說
講聲對唔住	說對不起
講聲多謝	說謝謝
講是非	說人是非
講少句	少說兩句
講笑	開玩笑
講笑搵第樣	別拿我開玩笑
講數	談判
講數口	談判
講書	講課
講說話	說話
講話有骨	話裡有話
講話	說
講話好似雞啄唔斷噉	說話沒個完
港人	香港人
講人事	講人情
講一套做一套	口不對心
講耶穌	說教
講嘢	說話
講嘢都冇句真	沒說過一句真話
講嘢都冇句真嘅	沒說過一句真話
講嘢鬼食泥咁	講話不清不楚
講嘢好乸型	娘娘腔
講嘢冇句真	沒有一句真話
鋼骨	鋼筋
鋼骨水泥	鋼筋水泥
鋼撈	不鏽鋼勞力士錶
弶	鉗
割頸	自刎
割禾	割稻子
高層	領導層
高速煲	壓力鍋
高大咗	長高了
高大衰	傻大個兒
高大威猛	高大威武
高竇	傲慢
高竇貓	高傲的人
高檔嘢	高檔貨
高戙戙	高高的
高高大大	很高大
高高竇竇	傲慢自大
高櫃	大衣櫃
高踭鞋	高跟鞋
高章	高明
高中學校	高級中學
高中書院	高級中學
高佬	高個子
高人工	高薪
哥爾夫球棍	高爾夫球桿
告	控告
告白	廣告
告到佢甩褲	把他告到底
告到你甩褲	一定投訴你
告假	請假
告唔入	罪名不成立
告票	傳票
孤寒	小氣
孤寒鐸	小氣鬼
孤寒到死	小氣得要命
孤寒鬼	小氣鬼
孤寒種	小氣鬼
孤寒佬	小氣鬼
沽空	賣空
姑仔	小姑子
姑姐	姑姑
姑丈	姑父
咕哩	苦力
咕嚕肉	古老肉
姑媽	姑姑
姑勿論	且不說
姑奶	大姑子
姑娘	護士
姑娘仔	小姑娘
姑婆	祖父的姐妹
姑太	丈夫的姑母
孤兒仔	孤兒
估	猜
古	故事
估錯	猜錯
估到	猜著
股經	股票資料
估估吓	瞎猜
鼓起泡腮	氣鼓鼓
古仔	故事
古靈精怪	古裡古怪
估唔到	想不到
鼓埋泡腮	氣鼓鼓
估啱	猜對
古縮	內向
蠱惑	狡猾
蠱惑仔	小混混
古玩舖	賣古玩的商店
古月粉	胡椒粉
顧住	留意
癐	累
癐到死死吓	累得夠戧
癐拉拉	累極了
癐晒	累了
掬	憋
穀	稻穀
掬爆	氣炸了
唂咕	可可
唂咕	可可
唂咕豆	可可豆
唂咕粉	可可粉
唂咕脂	可可脂
唂咕樹	可可樹
掬起泡腮	氣鼓鼓
掬氣	憋氣
穀牛	米象
局	圈套
焗	悶
焗	迫
焗茶	沏茶
焗親	中暑
焗出嚟	烤出來
焗飯	燜飯
焗盅	蓋碗
焗盅薦	蓋碗兒底下的托兒
焗爐	烤箱
焗悶	悶熱
焗宿氣	窩囊氣
焗薯	烤馬鈴薯
焗熱	悶熱
官	少爺
棺材本	老本
官非	官司
官仔骨骨	斯斯文文
官式	正式
官式訪問	正式訪問
觀音兵	護花使者
觀音竹	羅漢竹
罐頭刀	開罐器
供	分期付款
工	工作
供車	分期付款買車
攻打四方城	打麻將
公德心	公德觀念
公定字	擲硬幣
公飯	覆盆子
功夫	武術
供款	分期付款
公共屋邨	公宅
恭喜發財，利是豆來	恭喜發財，紅包拿來
公仔	洋娃娃
工仔	工人
公仔戲	木偶戲
公仔麵	方便麵
公仔書	漫畫
公治	公司三明治
公治	總匯三明治
公眾假期	公休假
公契	整座樓宇的買賣合約
供樓	支付房貸
供屋	房子分期付款
公司三文治	總匯三明治
公事包	公文包
公事喼	手提箱
公數	公司的開支
工業邨	工業園
貢	鑽
貢吓貢吓	鑽來鑽去
貢嚟貢去	鑽來鑽去
貢入	鑽進
公公	外祖父
共	和
共	湊
共一份	湊上一份
豁	咕嘟
豁	喝
豁豁聲	咕嘟咕嘟地響
瓜	死
瓜柴	死了
瓜得	完蛋
瓜椗	瓜蒂
瓜子口面	鵝蛋臉
瓜子面	鵝蛋臉
瓜直	死了
瓜咗	死了
瓜老襯	死了
瓜褦藤，藤褦瓜	瓜瓜蔓蔓互相牽連
瓜晒老襯	早就去世了
寡佬	光棍
寡母婆	寡婦
寡婆	寡婦
啩	吧
掛住	想念
掛住…	只顧…
掛歪咗	掛歪了
掛望	想念
乖乖仔	乖男孩
乖乖女	乖女孩
乖仔	好兒子
乖豬	乖孩子
乖女	好女兒
拐子佬	拐子
怪	奇怪
怪錯	錯怪
怪雞	奇怪
怪之得	怪不得
怪唔得	難怪
怪唔之得	怪不得
摑	打耳光
摑一巴掌	打一個耳光
關斗	跟頭
關你咩事	關你什麼事
關人！	管他呢！
慣	習慣
躀	摔
躀低	摔跤
躀跤	摔跤
慣咗	習慣了
慣咗喇	習慣了啦
躀咗一跤	摔了一跤
刮	搜刮
刮親	擦傷
刮粗龍	剝刮大筆錢財
刮到料	搜集到材料
刮花	刮破
刮料	打探消急
刮龍	受賄
刮削	剝削
刮友	找人
龜	烏龜
龜蛋	龜兒子
龜公	拉皮條的
龜公	王八
龜婆	鴇母
鬼打鬼	內鬨
鬼都怕	嚇人
鬼火咁靚	妖艷
鬼咁…	怪…的
鬼咁…	非常…
鬼叫你…	誰叫你…？
鬼古	鬼故事
鬼鬼哋	洋里洋氣
鬼鬼鼠鼠	鬼鬼祟祟
鬼仔	外國男孩
鬼知	誰知
鬼佬	外國人
鬼唔知咩	誰不知道？誰不知道哇
鬼馬	狡猾
鬼妹	外國女孩
鬼五馬六	烏七八糟
鬼揞眼	沒有眼光
鬼婆	洋女人
鬼殺咁嘈	吵死了
鬼殺咁喊	吵死了
鬼殺咁聲	吵死了
鬼死	極度
鬼死咁…	怪…的
鬼死咁…	極度…
鬼聲鬼氣	洋腔洋調
鬼上身	胡說八道
鬼上身	鬼魂纏身
鬼食泥	不清不楚
鬼銷	洋銷
鬼鼠	鬼祟
鬼鼠肉	贅肉
鬼頭	洋上司
鬼影都冇隻	人都走光了
貴寶號	貴號
貴到飛起	非常貴
貴價	貴
貴價貨	高價商品
貴格	氣質高貴
貴夾唔飽	價錢貴又吃不飽
貴過頭	太貴了
貴精不貴多	重質不重量
貴咗	升價了
桂林相思	相思鳥
貴利	高利貸
貴姓名	貴姓
櫃	櫃子
跪低	跪下
跪薦	跪拜時的墊子
櫃面	櫃台
櫃桶	抽屜
櫃位	櫃台
櫃位貓	招財貓
均真	認真
君之	反正
軍褸	軍大衣
滾	搞女人
滾	詐騙
滾錢	騙錢
滾攪	打擾
滾攪晒	打擾了
滾起	揚起
滾紅滾綠	搗亂
滾紅滾綠	胡說
滾軸溜冰	旱冰
滾軸溜冰鞋	旱冰鞋
滾腍	煮爛
滾腍晒	煮爛了
滾三滾四	到處遊騙
滾瀉	沸得溢出
滾水	開水
滾水借歪	讓開
滾水淥腳	匆匆忙忙
滾人	騙人
滾友	騙子
滾熱辣	滾燙
棍	棍子
棍	騙
棍波	手動擋
棍錢	騙錢
棍仔糖	棒棒糖
棍騙	哄騙
棍人	騙人
棍友	騙子
骨	一刻
骨	關
骨	骨頭
骨痺	肉麻
骨場	按摩院
骨緻	精緻
骨妹	按摩女郎
骨女	按摩女郎
倔	固執
掘	挖
𥇣	瞪
掘出	挖出
倔情	無情
倔篤	盡頭
掘金	淘金
𥇣實	盯死
倔頭	盡頭
倔頭巷	死路
倔頭路	死路
果檔	水果攤子
果占	果醬
果占麵包	果醬麵包
果欄	水果批發店
果撻	水果塔
過	再
過	漂洗
過大禮	納徵
過底紙	複寫紙
過檔	跳槽
過冬	過冬至
過埠	出國
過埠新娘	嫁到外國去的女子
過火	過份
過界	超過界線
過幾日	過幾天
過骨	過關
過去式	前女友
過海	去澳門賭錢
過海	渡江
過節	仇隙
過招	較量
過咗火	過了
過咗陣	過了一會兒
過咗身	去世了
過咗一排	過了一段時間
過造	旺季已過
過鐘	過了點
過主	滾
過橋	利用
過冷河	過清水
過嚟	過來
過路	滾
過龍	超過
過唔到	過不了
過唔到骨	過不了關
過唔去	故意刁難
過唔去	過不去
過廟	晚點
過門	出嫁
過晒界	超過界線
過晒鐘	過了時間
過晒龍	超過
過晒廟	晚點
過三關	井字棋
過山峰	眼鏡王蛇
過山烏	眼鏡王蛇
過身	去世
過手	經手
過水	涮
過時補水	加班費
過數	付賬
過樹榕	灰鼠蛇
…過頭	太…
過頭	沒頂
過頭冷衫	套頭毛衣
過頭笠	套頭
過頭笠	體恤
過雲雨	陣雨
過意得去	心安理得
過意唔去	過意不去
國字口面	四方臉
光	亮
光巉巉	刺目
光棖棖	刺目
光碟	光盤
光管	日光燈
光棍	騙子
光猛	光亮
光頭佬	禿子
光脫脫	光禿禿
捐	鑽
捐血	獻血
捐窿捐罅	無處不到
捐山窿	鑽山洞
捐入	鑽進
捲閘	金屬閘門
蝦	欺負
蝦	蝦子
蝦霸	欺負
蝦春	蝦卵
蝦得就蝦	肆意侵犯他人
蝦公	蝦
蝦蝦霸霸	仗勢欺人
蝦仔	小孩
蝦仔	小蝦
蝦子餅	老公
蝦瘌	小螃蟹
哈佬	喂！
蝦轆	蝦塊兒
蛤蟆	蟾蜍
蝦毛	小人物
蝦毛	小蝦
蝦毛仔	小人物
harsh	苛刻
蝦人	欺負人
蝦人蝦物	仗勢欺人
吓	啊
吓	著
…吓…吓	…著…著
霞氣	霧氣
吓	一下
吓吓	次次
下便	下面
下半世	下半生
下低	下面
下底	下面
下間	廚房
下個禮拜	下個星期
下晝	下午
下扒	下巴
下扒輕輕	隨便許諾
下舖上居	店屋
下世	下輩子
high	興奮
揩	蹭
揩親	被碰了一下
揩草	吸毒
揩花	蹭花
揩粉	吸毒
揩鑊	出了大問題
揩油	沾光
揩嘢	碰了釘子
嚡	粗糙
鞋	鞋子
鞋抽	鞋拔子
嚡嚡聲	歎息
鞋踭	鞋跟
鞋薦	鞋墊
鞋舖	鞋店
嚡熠熠	粗粗的
蟹	螃蟹
蟹春	蟹卵
蟹弶	蟹鉗
蟹膏	蟹黃
克戟	烤餅
嚇	嚇唬
客	顧客
嚇餐飽	嚇個夠
嚇餐死	嚇死了
嚇親	嚇著
嚇到標汗	嚇得直冒汗
客仔	客戶
嚇窒	嚇呆了
客𨋢	客運電梯
客路	客源
嚇我一驚	嚇我一跳
嚇一驚	嚇了一跳
喊	哭
喊包	淚包
喊餐飽	哭個夠
喊打喊殺	揚言要打人
喊到拆晒天	大哭
喊苦喊忽	叫苦連天
喊噉口	哭喪著臉
喊喊口	哭喪著臉
喊口	愛哭
喊路	哈欠
喊唔出	哭不出來
鹹	黃色的
鹹臭	臭
鹹臭襪	臭襪子
鹹菜	酸菜
鹹草	席草
鹹蟲	色狼
鹹蛋	鹹鴨蛋
鹹蝦	蝦醬
鹹鹹哋	鹹鹹的
鹹龍	港幣
鹹赧赧	齁鹹
鹹片	色情片
鹹濕	淫穢
鹹濕伯父	老色鬼
鹹濕電影	黃色電影
鹹濕鬼	色鬼
鹹濕佬	色狼
鹹濕片	色情片
鹹水	洋的
鹹水	海水
鹹水草	席草
鹹水貨	走私貨
鹹水喉	海水自來水管
鹹水海	海
鹹水樓	劣質樓房
鹹水話	不純正的話
鹹書	黃書
銜頭	頭銜
鹹魚	屍體
慳	省
慳錢	省錢
慳得幾多算幾多	能節約多少算多少
慳得過就慳	能省就省
慳得就慳	能省就省
慳地方	不佔地方
慳啲	省點用
慳啲啦	省了吧
慳啲使	省點用
慳電	省電
慳電膽	節能燈泡
慳翻	省卻
慳翻啖氣	省一點吧
慳家	節儉
慳雞	節省
慳儉	節省
慳慳地喇	省一點吧
慳皮	省錢
慳濕	吝嗇
慳水慳力	省時省工
慳水又慳力	省時省工
慳時間	省時
慳頭慳尾	十分節儉
慳位	不佔地方
慳油	省油
閒偈	閒話
閒閒哋	隨便
閒事	小事一樁
坑渠	下水道
行	走
行	走
行beat	巡邏
行咇	巡邏
行步路打倒褪	諸事不順
行出行入	進進出出
行出去	走出去
行出嚟	走出來
行大運	走好運
行得起	走得動
行得正，企得正	光明正大，秉公辦事，身正不怕影子斜
行得埋	合得來
行地方	到處去遊玩
行東行西	東溜西逛
行花街	逛花市
行花市	逛花市
行翻去	走回去
行翻轉頭	往回走
行婚禮	舉行婚禮
行街	逛街
行街紙	臨時身份證明書
行經	來月經
行蠱惑	出來混
行公司	逛商店
行過龍	走過了頭
行過嚟	走過來
行吓	走一走
行吓公司	逛逛商店
行行吓	走著走著
行行企企	無所事事
行後門	走後門
行開	走開
行開啲啦	走開！
行開咗	出去了
行近路	走近道
行樓梯	爬樓梯
行雷	打雷
行路	走路
行路唔帶眼	遇事盲目
行唔開	走不開
行唔埋	合不來
行唔喐	走不動
行孖咇	兩個人走在一起
行埋	走在一起
行埋	（婉）性交
行埋嚟	走過來
行埋一齊	來往
行山	遠足
行山砵	登山靴
行山徑	人行山路
行衰運	走背運
行水	買路錢
行上	走上
行先一步	死亡
行騷	走秀
行船	當水手
行船	通船
行梯	梯子
行天橋	當時裝模特兒
行勻	走遍
行勻全國	走遍全國
行運	走運
行人路	人行道
行人天橋	高架人行道
行入去	走進去
行入嚟	走進來
行一步睇一步	一步一步做著看
行夜市	逛夜市
呷	吸飲
呷醋	吃醋
考車牌	考駕駛證
考起	被考倒了
考唔到	考不上
考唔合格	考不及格
考柯佬	做口試
考牌	考執照
考醫生牌	考行醫資格證
孝義	孝順
姣	淫蕩
姣氣	威風
姣妹	騷包
姣婆	淫婦
姣婆藍	翠藍
姣屍扽篤	故作嬌媚
校巴	校車
喺	在
喺邊度	在哪裡
喺…度	在…
喺度	在這裡
喺企	在家
喺屋企	在家
喺屋企迆	在家裡無所事事
喺晒	都在
喺晒度	都在這兒
喺處	在這裡
係	是
係吖！	是啊！
係呀	是啊
係衙？	是嗎？
係噉	就這樣
係噉㗎啦	就是這樣
係噉先	先這樣
係噉先喇	就這樣吧
係噉話	就這樣吧
係噉意	隨便一點
係咁大	完蛋了
係就係	話雖如此
係…至啱	是…才對
係囉	是啊！
係路	對勁兒
係唔係	是不是
係咪	是不是
係咪真嘅	是不是真的
係咪…先	是不是…？
係咩？	是嗎？
係你先至好講呀	不要信口開河
係威係勢	夠氣派
係人都	誰都
係人都知	人人皆知
係人都唔	誰都不
係要	只有
黑	倒霉
黑啤梨	黑莓
黑超	墨鏡
黑底	黑社會背景
黑啡	清咖啡
黑房	暗房
黑加侖子	黑醋栗
黑古勒特	黑不溜秋
黑古勒掘	黑不溜秋
黑工	非法勞工
黑過鬼	倒霉透了
黑過墨斗	倒霉透了
黑過墨汁	倒霉透了
黑過鑊屎	黑漆漆
黑客	黑客
黑後	晚上
黑口黑面	黑著臉
黑仔	倒楣
黑椒	胡椒
黑孖孖	黑漆漆
黑癦屎	雀斑
黑擝擝	黑漆漆
黑咪麻	黑漆漆
黑瞇擝	黑漆漆
黑面	兇
黑面神	滿臉怒色的人
黑晒面	板著臉
黑線轆	黑線軸兒
黑提子	黑葡萄
扻	碰
扻崩	碰破
扻崩頭	磕破頭
扻親	碰傷
扻親個頭	碰了頭
扻爛	碰破
扻頭埋牆	自懲
堪	碼頭
含含聲	人聲鼎沸
冚	嚴密
冚唪唥	全
冚家	全家
冚家鏟	全家死絕
冚家富貴	全家倒楣
痕	癢
痕癢	發癢
摼	敲
亨尼	甜蜜的
肯制	願意
衡	快
衡	緊
行政總裁	執行長
衡晒	緊緊地
杏霜	杏仁茶
盒	盒子
恰	欺負
瞌	合眼
瞌著	睡著
瞌著咗	睡著了
瞌埋眼	合上眼睛
瞌眼瞓	打瞌睡
恰西	越位
瞌一陣	睡一會兒
合襯	合適
闔府	全家
闔府安康	全家安康
闔府統請	府上諸人均在邀請之列
盒仔飯	盒飯
合掌瓜	佛手瓜
闔埋雙眼	閉上眼睛
合眼	看得過去
闔眼	合眼
合眼緣	順眼
合皮	開心
合晒心水	正合人的意
合心水	合心意
合桃	胡桃
合桃酥	桃酥
乞	討
乞嗤	噴嚏
乞食	討飯
乞人憎	討人厭
乞兒	乞丐
乞兒公	老乞丐
核數	審計
核數師	審計師
吼	光顧
吼	看守
吼	要
吼斗	光顧
吼斗	想要
吼到正	抓個正著
吼機	等待時機
吼機會	等待時機
吼準	抓準
吼住	留意
吼住佢	看住他
吼路	找破綻
吼實	盯死
口	嘴
口臭	口不擇言
口齒	信用
口多多	嘮叨
口花花	多嘴
口快	嘴快
口快快	嘴快
口乾	渴
口乖	嘴甜
口果	零食
口嚡脷素	口淡而澀
口黑面黑	臉色難看
口痕	嘴巴癢癢
口輕輕	隨便許諾
口響	唱高調
口震	口吃
口震震	結結巴巴
口窒窒	結結巴巴
口腫面腫	鼻青臉腫
口立濕	零食
口唔對心	心口不一
口碼	口才
口擘擘	氣喘
口密	嚴實
口面	臉
口𥹉	結結巴巴
口啞啞	啞口無言
口硬	嘴硬
口噏噏	喋喋不休
口水嗲嗲渧	口水流個不停
口水多過茶	囉嗦
口水花	唾沫星子
口水花噴噴	口沫橫飛
口水肩	圍嘴
口水佬	嘴巴式
口水溦	唾沫星子
口水痰	痰
口脣	嘴脣
口脣膏	口紅
口疏	嘴快
口疏疏	嘴快
口爽	嘴快
口淡淡	沒胃口
口甜舌滑	油腔滑調
口黃	順口溜
喉	管
喉急	急
喉管	水管
喉嘴	氣門
喉嘴	閥
喉擒	性子急
喉鉗	管鉗子
喉欖	喉結
喉轆	消防水龍
喉嚨	嗓子
喉嚨拆晒	聲音沙啞
喉嚨椗	小舌
喉嚨痛	嗓子疼
喉腩	胃口
喉沙	嗓子沙啞
喉糖	喉片
喉核	喉結
後便	後面
後底乸	繼母
後枕	後腦勺
後嚟	後來
後屘	後來
後尾枕	後腦勺
後生	年輕
後生仔	小伙子
後生仔女	年輕人
後生女	年輕姑娘
後生細仔	小青年
候鑊	廚師
迆	懶散
迆吓	打發時間
起	興建
起膊	上肩
起菜	上菜
起底	摸清底細
起筷	動筷子
起翻身	爬起來
起飛腳	突襲
起貨	完工
起貨	裝貨
起雞皮	起雞皮疙瘩
起腳	起程
起弶	攻擊
起骨	剔骨頭
起哄	長水鏽
起踭	用肘部撞人
起枕	長繭子
起漬	長霉
起𦟌	長出腱子肉
起租	加租
起嚟	起來
起落貨	裝卸貨物
起爐	生火
起唔到身	起不了床
起尾注	偷
起霧	出現霧氣
起赧	起疹團
起錨	動身
起屋	蓋房子
起晒雞皮	起雞皮疙瘩
起晒弶	裝腔作勢
起晒哄	長滿水鏽
起勢	拼命
起勢噉	不停地
起勢噉做	拼命幹
起勢行	趕路
起勢傾	談個沒完
起身	起來
起身嚟	起來
起首	開始
起上嚟	起來
起先	起初
起頭	起初
起鑊	出鍋
起鑊	熗鍋
戲	電影
餼	餵養
氣泵	打氣筒
氣都透唔到	喘不過氣
戲服	戲裝
餼雞	餵雞
氣薦	氣墊
餼豬	餵豬
氣羅氣喘	氣喘吁吁
氣爐	煤氣灶
戲肉	好戲
hang機	當機
㗾	哈
㗾	噓
靴	靴子
㗾一啖氣	哈一口氣
墟	集市
墟巴嘈閉	吵吵鬧鬧
墟場	集市
墟冚	噪鬧
墟墟冚冚	聲勢巨大
墟日	趕集日
去廁所	上廁所
去大	大便
去大煙通	死
去得	可以去
去得過	值得去
去到咁盡	那麼過份
去到盡	拼命
去街	上街
去街買餸	上街買菜
墟咁嘈	吵吵鬧鬧
去就去啦	去就去吧
去咗	死了
去咗見周公	睡著了
去咗賣鹹鴨蛋	去世
去咗飲	做客去了
去咗遊埠	死了
去馬	上馬
去賣鹹鴨蛋	去世
去蒲	去娛樂場所玩
去細	小便
去水	排水
去水位	排水口
去飲	赴宴
香	死
香草奶昔	香草牛奶冰淇淋
香梘	香皂
香港地	香港這個地方
香港腳	腳氣
鄉下	家鄉
鄉下仔	土包子
鄉下佬	土包子
鄉下妹	土包子
鄉下婆	土包子
香口膠	口香糖
香蕉奶昔	香蕉牛奶冰淇淋
香咗	死了
鄉里	同鄉
鄉里鬼鬼	老鄉
香料粉	五香粉
香爐躉	獨生子
香噴噴	香香的
香片	茉莉花茶
香肉	狗肉
响	在
响邊度	在哪裡
响…度	在…
响度	在這裡
響鐘	鳴鐘
響螺	管角螺
响屋企	在家
响處	在這裡
响入面	在裡面
向前行	往前走
向西	朝西
謙虛過頭	過份謙虛
牽哈	哮喘
牽氣	捯氣
蜆	哈蜊
蜆殼	蛤蜊殼
蜆肉	蛤蜊肉
獻世	敗家
興	流行
兄弟	男儐相
馨香	光彩的
㷫	熱鬧
㷫	熱
㷫	生氣
㷫親	燙傷
㷫乾	烘乾
㷫烚烚	熱辣辣
㷫起嚟	來勁
㷫熱	烤熱
蠍	蠍子
歇手	停手
囂屎	囂張
曉	懂
河	米粉條
河粉	米粉條
可唔可以	可不可以
荷包	錢包
荷包倒吊	揮霍錢財
荷包糠	錢少
荷包糠糠哋	身邊沒有現錢
荷包仔	扒手
荷包亂揈	揮霍錢財
荷包𥹉	小氣
荷包友	扒手
河壆	河堤
河涌	小河
荷官	發牌者
荷蘭豆	豌豆
荷蘭水	汽水
荷蘭水蓋	勳章
荷蘭薯	馬鈴薯
河孖	隨機分組
賀咭	賀卡
荷里活	好萊塢
賀年咭	賀年卡
開便	外面
開波	發球
開大	大解
開檔	開張
開檔打牌	開始打麻將
開到通頂	開到天亮
開荒牛	開拓者
開記招	開記者會
開句聲	說幾句
開估	揭曉
開工	工作
開公數	由公司開支
開吓眼界	開開眼界
開坑	挖坑
開口棗	芝麻棗
開口及著脷	說錯話
開口埋口	動不動
開口夢	夢話
開口有話	有道是
開齋	開始有所收穫
開枝散葉	宗族繁衍
開鑼	開始
開浪褲	開襠褲
開咪	開麥克風
開眼界	打開視野
開O.T.	加班
開派對	開舞會
開P	開舞會
開片	群鬥
開舖	開門
開舖頭	開門
開盤	開始發售
開篷車	敞篷車
開心到飛起	非常開心
開身	開船
開聲	作聲
開水喉	開水龍頭
開善堂	開辦慈善機構
開騷	開始表演
開天索價	索高價
開拖	交手
開枱食飯	擺桌子吃飯
開胃	胃口好
開胃咯	別妄想
開鑊	性交
開夜	上夜班
海賊	海盜
海鱟	鱟魚
海洛英	海洛因
海味	乾海產
海味舖	乾海產店
海皮	海邊
海洋館	水族館
害死	拖累
害人害物	害苦了別人
殼	勺
學	像
學似	像
學斗	小白菜
學精	學乖
學期尾	學期末
學生哥	男學生
學生妹	女學生
學師仔	學徒
學是學非	搬弄是非
學堂	學校
學堂	警校
學位	學額
學人	學著別人
學人口水溦	學舌
學嘢	學習
看檔	看店
看更	守夜
看牛	放牛
看護	護士
漢堡扒	漢堡排
看低	小看
寒	怕
寒背	駝背
寒寒凍凍	冷
韓文	韓語
寒暑表	溫度計
汗漬	汗跡
汗宿	汗臭
康健	健康
糠	乾燥
糠	發霉變質
糠	錢少
糠米	發霉的米
行貨	大路貨
行家	內行
行頭	行業
巷篤	街巷的盡頭
巷仔	小巷
渴市	商品緊俏
好	很
好吖！	好的！
好呀	好吧
好弊	很糟糕
好逼人	很擁擠
好波	好球
好補	很滋補的
好斜	很陡
好邪	很邪門
好唱口	心情好
好似	好像
好似…噉	像…似的
好似係	好像是
好潮	很時尚
好彩	幸虧
好彩數	運氣好
好大數	數目很大
好膽	大膽
好抵	很合算
好地地	好好的
好啲	好一點
好定當	不慌不忙
好多潺	黏液很多
好多時	經常
好多勻	很多次
好到冇朋友	好極了
好化學	質量很差
好翻	好轉
好翻晒	已經好了
好瞓	睡得香
好friend	很要好
好灰	很灰心
好合	合得來
好交關	很厲害
好計仔	好主意
好頸	脾氣好
好勁	很厲害
好癐	很累
好焗	很悶
好鬼	極
好鬼死	非常
好鬼死難頂	真受不了
好…吓	挺…的
好high	很興奮
好閒	沒什麼
好閒㗎啫	沒什麼
好行	慢走
好孝義	很孝順
好口	嘴巴甜
好口碼	好口才
好氣	羅嗦
好好	很好
好好多	好很多
好好口	嘴巴很甜
好好味	很好吃
好好睇睇	體面
好盞	很好
好賺	賺得多
好仔	好孩子
好正	非常好
好在	幸好
好做得	很能幹
好近	很近
好傾	很談得來
好傾好講	愛說話
好橋	好辦法
好蹺	很巧
好叻	很聰明
好靚	很漂亮
好娘	很老套
好力	力氣大
好老脾	好脾氣
好唔掂	真不順當
好唔好	好不好
好微	很小
好味	好吃
好命	命好
好冇心機	很不專心
好難摱	無法挽回
好嬲	很生氣
好啱key	很投機
好眼	眼力好
好惡講	很難說
好惡行	很難走
好耐	很久
好耐好耐之前	很久很久以前
好耐冇見	好久不見
好曬	很曝曬
好世界	富有
好細聲	聲音很小
好心機	細心
好心著雷劈	冤枉
好心你	勞駕
好死	好
好聲	小心
好聲好氣	心平氣和
好衰㗎	討厭
好衰唔衰	更糟糕的是…
好相與	好商量
好食	好吃
好醒	很機靈
好少少	好點了
好嗍氣	很吃力
好睇	好看
好睇過睇戲	很精彩
好頭好尾	有始有終
好天	晴天
好天時	好天氣
好肚餓	很餓
好話	謝謝
好話好話	哪裡哪裡
好話喇好話喇	哪裡哪裡
好話唔好聽	老實話
好話為	好辦
好喫	好吃
好陰功	很可憐
好飲	好喝
好飲得	酒量大
好飲好食	愛吃喝
好人	不得罪人的人
好人	人品好
好人好姐	好人一個
好人事	心腸好
好人有限	不是什麼好人
好嘢	很好
好夜	很晚
好樣	好看
好意頭	吉利
好易話為	很容易辦的事
好型	很酷
好食懶飛	好吃懶做
毫	角
蠔	牡蠣
蠔豉	牡蠣乾
蠔油菜薳	蠔油炒嫩菜心
…號	…路
烘底	先在烤箱裡烘過的三明治
空殼公司	空頭公司
空姐	女空服員
空框框	空蕩蕩
空寥寥	空空的
兇神惡	很兇
兇神惡殺	很兇
空手掉空臂	無事可做
空少	男空服員
胸圍	胸罩
控制唔到	控制不了
紅	血
紅蔔蔔	紅紅的
紅菜頭	甜菜
紅豆	紅小豆
紅豆沙	紅豆湯
紅噹噹	通紅
紅當蕩	紅彤彤
紅汞水	紅藥水
熊仔	小熊
紅蘿蔔	胡蘿蔔
熊貓噉嘅眼	有黑眼袋
紅毛泥	水泥
紅衫	金線魚
紅衫魚	金線魚
紅十字車	救護車
紅色炸彈	請帖
紅鬚綠眼	洋人
紅提子	紅葡萄
紅油	紅色油漆
哄	日月暈
哄	水鏽
哄	湊近
哄住睇	圍著看
圈中人	圈內人
勸交	勸架
揸	拿
揸	開
揸筆	寫文章
揸筆忘字	提筆忘字
揸車	開車
揸槍	拿槍
揸錢	管理錢財
揸大葵扇	做媒人
揸兜	要飯
揸的士	開出租汽車
揸電單車	騎摩托車
揸到實	抓緊
揸筷子	拿筷子
揸弗	管事
揸弗人	主事人
揸緊時間	抓緊時間
揸機影相	拿照相機拍照
揸頸	受氣
揸頸就命	忍氣吞聲
揸工業	抓工業
揸起拳頭	握著拳頭
揸開	開走
揸掣	捏閘
揸正嚟做	秉公處理
揸莊	做主
揸主意	拿主意
揸住	拿著
揸住支咪	抓住麥克風
揸住時機	抓住時機
揸靚車	開高級轎車
揸唔到主意	拿不了主意
揸唔穩	拿不穩
揸拿	把握
揸奶	擠牛奶
揸農業	抓農業
揸實	抓緊
揸手	捏著
揸手掣	捏閘
揸水	去小便
揸水	擠出水分
揸上手	拿在手裡
揸數	管錢
揸舦	掌舵
揸軚	掌舵
揸拖拉機	開拖拉機
揸痛腳	抓辮子
揸黃腳雞	捉姦
揸二攤	買舊貨
渣	渣滓
鮓	差
鮓斗	差
鮓皮	差
咋	…而已呀
詐	裝
詐病	裝病
詐諦	裝蒜
詐癲扮傻	裝瘋賣傻
詐癲賣戇	裝瘋賣傻
詐瞓	假睡
詐假意	假裝
詐奸	耍奸
炸雞	炸彈
詐嬌	撒嬌
詐嬌弄嗲	撒嬌
詐詐諦諦	裝模裝樣
炸兩	炸腸
詐聾扮啞	裝聾作啞
詐唔知	假裝不知道
詐媽嬌	撒嬌
炸麵	油條
詐懵	裝糊塗
詐呆詐吽	裝傻
詐戇	裝傻
詐死	裝死
詐傻	裝傻
詐傻扮懵	裝瘋賣傻
痄腮	腮腺炎
炸粟米	爆米花
詐糊	搞錯
詐糊	還沒和牌
詐耳聾	裝聾作啞
詐型	擺架子
喳喳林	迅速
拃	把
齋	素的
齋腸	素粉條
齋菜	素菜
齋啡	清咖啡
齋講	光說
齋館	素食餐廳
齋鹵味	素什錦
齋噏	廢話
齋睇唔買	光看不買
齋talk	淨是說話
齋湯	素湯
齋堂	道觀
債仔	債戶
窄	狹窄
窄	瘦
責	壓
責親	壓傷
責袋	帶錢
責住	壓著
窄搣搣	窄窄的
責年	壓歲
責實啲	壓緊一點
責死	壓死
摘	採
擇使	麻煩
擇食	偏食
䁪	眨
斬	砍
斬柴	打柴
斬柴佬	樵夫
斬到一頸血	敲竹槓
斬件	剁成塊兒
䁪吓眼	一眨眼
䁪吓眼就…	一眨眼就…
斬纜	分手
䁪眉䁪眼	擠眉弄眼
䁪眼	眨眼
斬手指	戒賭
斬傷	砍傷
斬樹	砍樹
斬頭	砍頭
斬頭鬼	該死的
斬人	砍人
盞	好
賺	徒勞
趲	走
賺得	空有
賺得個	空有
賺攪	白忙活
盞鬼	好
賺做	白幹一場
賺嘥氣	白費勁
賺衰	自找倒霉
盞嘢	好東西
讚	稱讚
賺到盤滿缽滿	大大賺了一筆
賺唔到錢	賺不了錢
爭	欠
踭	肘
爭崩頭	競爭劇烈
爭…錢	欠了…的錢
爭錢	欠錢
爭啲	差點
爭啲唔記得咗	差點忘了
爭到七彩	爭論得熱鬧非凡
爭翻啖氣	爭口氣
爭交	吵架
爭幾回	差點
爭好遠	差得很遠
爭隻腳	三缺一
爭住	搶著
爭住食	搶著吃
爭住先	先欠著
爭佢兩蚊	欠他兩塊錢
爭兩個人	缺兩個人
爭詏	爭執
爭成條墟	差得很遠
爭食	搶著吃
爭位企	搶位子
爭人錢	欠人錢
䂻	脹
掙	撐
掙唔落	塞不下
掙滿晒	塞滿了
㗱	咂
閘	門
雜	葷的
雜	雜碎
雜菜	葷菜
雜貨舖	雜貨店
鈒骨	鎖邊
雜果賓治	雜果潘趣飲料
閘口	剪票口
㗱㗱聲	咂咂
集中唔到	無法集中心思
閘住	住口
閘住把口	住口
雜嘜	雜牌
扎	跳起
紮	捆
紮	束
紮辮	梳辮子
紮腳	纏足
紮腳	纏足
扎起	跳起來
紮胸	束胸
扎扎跳	活潑
紮職	升級
紮住個頭	把頭包扎起來
扎孖辮	扎著雙辮
扎馬	扎馬步
紮炮	挨餓
紮實	綁牢
扎醒	驚醒
抓	纏繞
找贖	找
抓住	捆著
抓實	捆好
找數	找錢
找數	結帳
找換	兌換
找換外幣	兌換外幣
罩籬	笊籬
棹忌	忌
驟眼睇	一眼看上去
擠	放
擠逼	擁擠
擠喺	放在
擠喺枱面	放在桌面
擠住	放著
擠塞	堵塞
擠提	擠兌
擠擁	擁擠
仔	男孩
仔大仔世界	兒大不由娘
仔乸	母子
仔女	兒女
仔爺	父子
制	剎車
制	限制
制	願意
掣	電鈕
制得過	划得來
制電	停電
制住	被限制
掣住架車	把車剎住
祭旗	拿一個人開刀
制唔過	划不來
制唔制	願不願意
制水	停水
囝囝	兒子
滯	難消化
滯口	胃口不好
側邊	旁邊
側便	旁邊
側鏡	側視鏡
側側膊	推卸責任
斟	倒
斟	談
針	蜇
斟茶	倒茶
斟出	倒出
斟出嚟	倒出來
斟吓	談談
斟酒	倒酒
斟唔掂	談不妥
斟盤	談判
斟瀉	倒得溢出
斟水	倒水
斟豉油	倒醬油
針筒	注射器
枕	繭子
枕長	經常
枕住	經常
枕頭包	方麵包
枕頭袋	枕頭套
枕頭肉	枕芯
枕肉	枕心兒
浸	泡
浸過鹹水	出過國留學
浸鹹水	留學
浸浸涼	涼嗖嗖
浸腍	泡軟
浸死鴨乸	遙遙無期
浸死鴨乸咁耐	遙遙無期
浸溫泉	泡溫泉
浸浴	泡澡
朕	股
沉	淹
沉親	溺死
沉死	淹死
真抵	真便宜
…真啲	認真…
真火滾	真生氣
真係	真的
真係火滾	真叫人惱火
真係盞	真好
真係甩鬚	真丟臉
真係唔似樣	真不像樣
真係衰嘅啫	次透了
真係有心	您真的很關心我
真黑	真倒霉
真空膽	真空管
真揸頸	真氣人
真撞板	真糟糕
珍珠都冇咁真	千真萬確
真蹺	真巧
真冇修	真沒轍
真冇收	真拿他沒辦法
真衰	真倒霉！
真嗍氣	真費勁
真有心	你真好心
震	發抖
鎮場	壓場
震震貢	動個不停
震揗揗	顫抖
鎮頭	集鎮
陣	一會兒
陣間	一會
陣間先講	一會再說吧
陣間會講	等一會兒會說
憎	恨
憎死	恨透
憎人富貴厭人窮	吃不到葡萄說葡萄酸
贈慶	湊趣
執	倒閉
執	撿
執包袱	打包袱
執包袱	辭工
執茶	抓藥
執齊	收拾好
執齊啲嘢	把東西收拾好
執齊行李	收拾好行李
執籌	抓鬮
執床	收拾床鋪
執定	收拾好
執碟	收拾碗筷
汁都撈埋	有什麼好處就自己全吞了
執到	撿到
執到寶	走運
執到都喊三聲	便宜沒好貨
執到著數	撿便宜
執到正	打扮得很漂亮
執翻	撿回
執翻嚟	撿回來
執翻條命	僥幸逃生
執房	收拾房間
執雞	撿到便宜
執雞腳	抓痛腳
執吓張床	收拾一下床鋪
執行李	收拾行李
執起	撿起
執起嚟	撿起來
執好	收拾好
執仔	接生
執仔婆	接生婆
執滯	死板
執正	打扮
執正	按原則
執正啲	打扮
執字粒	排字
執笠	倒閉
執漏	補漏
執屋	打掃房子
執平嘢	買便宜貨
執山草藥	抓草藥
執生	應變
執拾	收拾
執拾乾淨	收拾乾淨
執拾好行李	收拾好行李
執手尾	善後
執死雞	撿到便宜
執死雞	脫手
執死雞	買退票
執死雞仔	撿到便宜
執屍	收屍
執私	緝私
執式	小氣
執蘇州屎	收拾爛攤子
執輸	佔下風
執輸過人	比人差
執條襪帶累身家	得不償失
執枱	收拾桌子
執人口水溦	學舌
執贏	佔上風
執藥	抓藥
執二攤	買舊貨
枳	塞
枳	塞
枳	隨便放
質	質問
質地	質料
質素	素質
枳入	塞進
姪	姪子
窒	害怕
窒腳	走路時突然停一下
窒口窒舌	結結巴巴
姪仔	姪子
窒住	停住
姪心抱	姪媳婦
窒手	縮手
窒人	損人
洲	島
周不時	時常
周街	滿街
周街係人	滿街都是人
周街走	滿街跑
周身	全身
周身八寶	本領多
周身打震	渾身顫抖
周身打冷震	凍得上牙打下牙
周身刀冇張利	什麼都只懂一點
周身唔得閒	忙得很
週身唔聚財	全身不舒服
周身唔自在	身體不舒服
周身唔舒服	一身不舒服
周身唔妥	一身不舒服
週身冇力	渾身軟綿綿的
週身冇蚊	身無分文
周身蟻	惹禍上身
周身濕晒	全身都濕透了
周身濕晒	滿身都濕透了
周身屎	惹禍上身
週身酸痛	渾身酸疼
周身痛	全身痛
周身喐	渾身動
周時	常
周時無日	經常
周處	到處
周圍	到處
周圍唱	四周張揚
走	不加
走	跑
酒餅	酒曲
走冰	不加冰
走寶	吃虧
走青	不加蔥
走出去	跑出去
走出嚟	跑出來
酒埕	酒罈
走蛋	不加雞蛋
走得	可以走
走得幾快吖	能跑多快呀？
走趯	走動
酒店	飯店
走電	跑電
走都走唔切	逃跑也來不及了
走法律罅	鑽法律空子
走粉	走私白粉
走埠	走江湖
酒家	大飯館
走雞	吃虧
走雞	走脫
走雞	錯過
走雞西水	逃難
走鬼	躲警察
走過嚟	跑過來
走去	跑去
走趲	迴旋
酒樽	酒瓶
走咗	死了
走甩	逃脫
走甩咗	逃脫了
酒樓	大飯館
走囉	走吧
走路	逃亡
走唔切	跑不掉
走唔起	跑不動
走唔甩	逃不掉
走埋嚟	撞過來
走難	逃難
酒凹	酒窩
酒牌	經營酒類生意的執照
走晒音	跑了調
酒筲箕	好酒量
走西水	逃難
走先	告辭
走雪	去冰
走投	走人
走堂	翹課
走糖	不加糖
走音	跑調
走人	走
走入去	跑進去
走入嚟	跑進來
走油	過油
走肉	不加肉
就	將要
就	遷就
…就得	…即可
…就得啦	…即可
就快	快
就假嘅	才怪呢
就噉啦	就這樣吧
就噉算	就此罷休
就噉算數	就此罷休
就近	附近
就腳	方便
就吓佢	遷就他一下
就係	就是
就係講	就是說
袖口鈕	袖釦
就住	遷就
就住晒	處處遷就
就嚟	快
就晒	總是遷就
就手	順利
就算	即使
…姐	姐
啫	而已
遮	擋
遮	雨傘
遮柄	傘桿兒
遮骨	傘枝
遮住	擋著
啫喱	果凍
啫喱豆	軟心豆粒糖
遮唔住	掩蓋不了
…姐	姐
蔗	甘蔗
借畀	借給
借啲意	趁機
蔗汁	甘蔗汁
借借	借光
借力打力	順勢而為
蔗纈	甘蔗節
借問聲	請問一下
借問一聲	請問一下
借歪	借光
借歪啲	借光
蔗水	甘蔗湯
借人過橋	利用別人
借一借	借光
姐姐仔	姑娘
jacket	夾克
隻抽	單挑
隻抽隻	單打獨鬥
脊骨	脊椎
隻眼開隻眼閉	睜一隻眼閉一隻眼
占	果醬
精	機靈
精	自私
精出骨	自私
精乖	精靈
精乖乖	精靈
精乖伶俐	聰明伶俐
精仔	投機取巧的人
精甩辮	精明
精甩尾	精明
精叻	聰明能幹
精埋一便	專把聰明用在做壞事或為自己打算上
井字過三關	井字棋
正	棒
正斗	好
正斗貨	正牌貨
正斗嘢	正牌貨
正牌	正宗的
正晒	正好
正嘢	正牌貨
誅	逼問
追翻	趕上
追斬	追殺
追埋去	追上去
追女仔	泡妞
追數	追債
咀	親吻
嘴	嘴巴
嘴刁	挑嘴
嘴角𠴕起	看不起人
咀嘴	接吻
嘴𠴕𠴕	撇撇嘴
咀一啖	親一下
最弊	最壞
醉到成坺泥噉	爛醉如泥
醉到一劈屎	爛醉如泥
最佳拍檔	最好夥伴
醉酒佬	醉漢
醉咗	醉了
醉貓	醉鬼
最屘	最後
最細	最小
聚腳	聚首
聚腳地	聚首的地方
雀	鳥
著	穿
著草	走人
雀竇	鳥窩
著緊	穿著
著好	穿好
雀仔	鳥兒
雀仔竇	鳥窩
著住	穿著
著褸	穿大衣
著襪	穿襪子
著名牌	穿名牌
雀屋	鳥舍
著皮草	穿毛皮服裝
著衫	穿衣服
雀粟	鳥食
著鴛鴦襪	穿錯襪子
著	對
著燈	開燈
著緊	著急
著數	好處
樽	瓶子
津白	天津白菜
樽頸	瓶頸
樽蓋	瓶蓋
樽口	瓶口
樽枳	瓶塞
樽裝	瓶裝
樽裝啤酒	瓶裝啤酒
樽裝水	瓶裝水
樽裝飲品	瓶裝飲料
樽塞	瓶塞
樽身	瓶身
準備定當	準備停當
準決賽	半決賽
進行清盤	結業
盡	絕
盡地	盡
盡晒人事	已經盡了最大的努力
盡人事	盡能力辦事
將	把
將近	快要
…張幾	…十多歲
獎	獎勵
掌上壓	俯臥撐
仗	次
脹卜卜	脹鼓鼓
帳幕	帳篷
象拔	象鼻子
橡筋	橡皮圈
捽	搓
蟀	蟋蟀
捽腳	搓腳
卒之	終於
捽老泥	搓汗垢
捽唔甩	擦不掉
捽眼	揉眼
捽手	搓手
之	但
知	知道
螆	疥蟲
之不過	但是
知醜	知恥
之但係	不過
知啲唔知啲	一知半解
知到	知道
之古律	巧克力
知客	接待員
知慳識儉	精打細算
支質	囉唆事
支支整整	過份講究打扮
姿整	講究
姿整	蹭
知唔知	知不知道
之嘛	而已
知死	後悔莫及
知衰	知錯
資訊總監	信息長
芝士	奶酪
芝士蛋糕	起司蛋糕
芝士漢堡	起司堡
之所謂	所謂
知書識禮	知書達禮
知書識墨	有文化
知頭唔知尾	知其一不知其二
滋悠	從容
紙	證件
紙	鈔票
指甲	手指甲
指甲鉗	指甲刀
紙巾	面紙
只係	只是
紙紮	紙做的
紙紮公仔	沒用的人
紙紮下扒	說話輕諾
紙紮祭品	香燭用品
紙紮老虎	紙老虎
紙紮舖	香燭用品店
指指督督	評頭論足
指指彈彈	評頭論足
指模	指印
姊妹	女儐相
姊妹	姐妹
紙皮	瓦楞紙
紙皮盒	瓦楞紙盒
紙皮石	馬賽克
紙皮箱	瓦楞紙箱
指擬	指望
指擬你	指望你了
紙鷂	風箏
至	才
至	最
至弊	最糟
至得	才行
至多	頂多
至多唔係	大不了
置翻頭家	成家
置家	成家
至緊要	最重要
至係	才是
至好	才好
至好唔係	不是才怪
至憎	最討厭
志在	在乎
志在	目的在於
…至奇	…才怪
至啱	才對
至啱	最適合
置業	購置產業
吱吱喳喳	唧唧喳喳
吱吱斟	竊竊私語
吱吱斟斟	竊竊私語
字	五分鍾
治	鎮
自把自為	自作主張
自爆	自己洩露
自不然	自然
治邪	闢邪
自動波	自排車
自己攞嚟衰	自找麻煩
自己友	自己人
自在	舒服
字墨	學問
自摸	贏牌
自細	從小
自細嚇大	天不怕
自梳	終生不嫁
自梳女	獨身女子
字頭	堂口
芝娃娃	吉娃娃
自慰	手淫
則	藍圖
即	就
漬	垢
癪	疳積
積	勾
織	編
積錢	攢錢
積犯	慣犯
即管	儘管
即係	就是
即係話	就是說
即刻	馬上
即刻扯！	快走開！
癪滯	消化不良
織蟀	蟋蟀
積積埋埋	日積月累
織蓆	編席子
織冷衫	打毛衣
則樓	建築事務所
即嚟	馬上來
織籮	編籮筐
積埋啲錢	把錢攢下來
則師	建築師
則師樓	建築事務所
即食麵	方便麵
即睇	馬上看
積陰功	積德
即映即有	現拍現看
直白	直率
直白講	老實說
直筆甩	筆直
直腸直肚	心直口快
直情	簡直
值得嘅	值得的
直行	直走
值晒票價	值回票價
直頭	簡直
直通車	直達車
櫼	揳
櫼	楔子
尖筆甩	尖尖的
櫼隊	加塞兒
沾寒沾凍	乍寒乍冷
尖嘴雞	嘴硬的人
櫼實	揳緊
氊	毯子
煎薄罉	薄餅
煎堆	麻團
氈酒	金酒
煎佢皮	對他恨之入骨
煎皮拆骨	剝皮抽骨
煎pan	平底鍋
𦟌	腱子
剪齊𩬎	剪齊劉海
剪陸軍裝	剪平頭
剪手甲	剪指甲
薦	墊
薦瞓衫	睡衣
薦高	墊高一點
薦高枕頭	想清楚
薦起	墊起來
箭嘴	箭頭
箭豬	豪豬
薦盤	托盤
薦枱腳	墊桌腿
薦褥	褥子
賤格	下賤
晶片	芯片
精神爽利	精神飽滿
蒸水蛋	蛋羹
整	弄
整親	弄傷
整車	修車
整出嚟	弄出來
整定	註定
整翻	修理
整翻幾味	弄幾道菜
整翻好	修理好
整飯	煮飯
整古	作弄
整古做怪	裝神弄鬼
整古弄怪	做鬼臉
整鬼	搞鬼
整鬼整怪	做鬼臉
整鬼整馬	搞什麼鬼
整鬼面	做鬼臉
整喊	弄哭
整資料	整理資料
整整吓	慢慢地
整爛	弄壞
整爛咗	弄壞了
整路	補路
整亂	弄亂
整唔切	來不及做
整唔掂	弄不好
整唔翻	修不好
整盲	弄瞎
整乜嘢鬼	搞什麼鬼
整衰	搞砸
整衰晒	越弄越糟
整傷	弄傷
整色整水	裝樣子
整色水	裝樣子
整成…嘅習慣	養成…的習慣
整餸	做菜
整損	弄破
整損手	把手弄破了
整痛	弄痛
整污糟	弄髒
正貨	正牌貨
政棍	政客
正喺度	正在
正啱	剛巧
正式	真正
正話	剛才
正一	真正
剩	剩
淨	只
剩低	剩下
剩得	只有
剩翻	剩下
靜雞雞	靜靜地
剩腳	殘貨
靜吓	安靜一下
淨係	只是
靜靜雞	偷偷的
靜落嚟	安靜下來
淨麵	光麵
靜英英	靜悄悄
摺	疊
摺埋	摺疊起來
摺衫	疊衣服
接受唔到	不能接受
擳	撓
瀄	濺
擳胳肋底	撓胳肢窩
瀄牙膏	擠牙膏
擳人	胳肢別人
折墮	作孽
折墮	倒霉
節瓜	毛瓜
折頭	折扣
截車	攔出租車
截的士	攔出租車
捷式	捷泳
蕉	香蕉
招呼	招待
招呼唔到	招待不周
招呼人客	招待客人
招積	誇耀
朝朝	每天早上
朝朝早	每天早上
朝早	早上
蕉皮	香蕉皮
朝頭早	早上
照	照樣
照	當
照板煮碗	如法炮製
照板煮糊	如法炮製
照肺	給上司責罵
照噉睇	如此看來
照噉睇嚟	如此看來
照鏡	照鏡子
照吓鏡	照照鏡子
照殺	照做不誤
照彈	照樣受到批評
照頭	當頭
照頭淋	迎頭澆
照頭一棍	當頭一棒
噍	嚼
摷	捶
噍吹波膠	嚼泡泡糖
噍骨頭	啃骨頭
噍香口膠	嚼口香糖
噍爛	嚼碎
噍唔喐	嚼不動
噍頭	嚼勁
摷一輪	痛打一頓
咗	了
阻	妨礙
阻	擋
左便	左邊
右膊	右肩
左膊	左肩
阻埞	礙事
阻街	堵路
左揀右揀，揀個爛燈盞	挑來挑去，最後還是挑了個壞的
左近	附近
左口魚	比目魚
左仔	香港左派
阻滯	障礙
阻住	擋著
阻住地球轉	形容某些人阻礙人家發展
阻唔到	阻止不了
左諗右諗	左思右想
阻你一陣	打擾你一下
左手便	左邊
阻手阻腳	礙手礙腳
阻時間	費時
左軚	方向盤在左邊的汽車
左軚車	方向盤在左邊的汽車
左睇右睇	左看右看
阻頭阻勢	礙事
左吆	左撇子
左撓	左撇子
左撓仔	左撇子
坐	放
座廁	馬桶
坐低	放下
座地	落地
座地燈	落地燈
座地風扇	落地電扇
座地喇叭	落地喇叭
坐定嗰粒六	氣定神閒
坐定粒六	氣定神閒
座駕	小汽車
坐喺	放在
再講	再說
再…過	再來
再起	重建
再嚟	再來
再嚟過	再來一次
在生	活著
geogra	地理
作	編
作嘔	要嘔吐
作病	生病
作出	編出
作大	誇張
作對	創作對聯
作反	造反
作感冒	鬧感冒
作個古仔	編個故事
作古	編故事
作怪	搞鬼
作狀	裝模作樣
䁓	看
裝	盛
裝彈弓	設圈套
䁓到正	逮個正著
裝飯	盛飯
裝假狗	裝蒜
䁓吓先	偷偷地看一下
裝香	上香
莊荷	發牌者
裝住嘢	裝著東西
裝唔落	盛不下
裝唔穩	裝不牢
裝身	打扮
裝修佬	裝修師傅
撞邪	倒楣
撞鬼	見鬼
漴	沖
撞板	碰壁
撞板多過食飯	成功少碰壁多
撞親	碰傷了
撞車	車禍
撞彩	碰運氣
撞翻	重逢
撞火	生氣
撞見	碰見
撞棍	騙子
撞口撞面	經常碰見
撞正	正碰上
撞蹺	碰巧
撞埋	碰在一起
撞面	碰見
撞啱	碰巧
撞死馬	莽撞的人
漴水	沖水
狀師	律師
撞樣	撞臉
租房	租房間
租金	房租
糟質	糟蹋
棗	棗子
早啲翻嚟	早點回來
早翻遲收	早到晚走
早瞓	早睡
祖家	老家
早走早著	走為上著
早排	前陣子
早晨	早
早晨	早
早唞	晚安
早一排	前陣子
造	旺季
造	茬
做把戲	耍把戲
做邊行	做哪一行
做出嚟	幹出來
做錯	做錯
做錯嘢	做錯事
做大戲	演粵劇
做大龍鳳	鬧事
做低	幹掉
做得	能幹
做電燈膽	做電燈泡
做電影	拍電影
做到嘢	能幹
做到七彩	幹活累得頭暈眼花
做到七個一皮	工作緊張得手忙腳亂
做到金睛火眼	忙得不亦樂乎
做到氣咳	忙得喘不過氣來
做到甩肺	幹活累得半死
做到死死吓	沒命地幹
做冬	過冬至節
造法	做法
做飛數	做面部美容
做雞	當妓女
做極都唔掂	怎麼做也做不過來
做京戲	唱京劇
做龜公	當王八
做戲	演戲
做戲做全套	演戲演到底
做兄弟	當男儐相
做姊妹	當女儐相
做節	過節
做做吓	做了一段時間
做豬仔	被收買了
做落去	做下去
做老襯	對親家
做唔切	來不及做
做唔掂	做不來
做唔到	辦不到
做唔嚟	做不來
做唔晒	做不完
做唔完	幹不完
做媽咪	當媽媽
做馬	內定結果
造馬	內定
造馬	內定
做埋老襯	對了親家
做埋晒	盡做
做乜	幹嘛
做乜噉嘅？	怎麼會這樣
做咩	幹嘛
做咩啫？	怎麼了？
做鴨	當男妓
做臥底	做內應
造愛	做愛
做part-time	做兼職工作
做散使	做零用
做手信	做禮物
做先生	當老師
做盛行	做哪一行
做騷	作秀
做數	做賬
做數	造假賬
做頭	當頭兒
做廳長	在客廳睡覺
做艇仔	做中間人
造人	生小孩
做人情	送禮
做嘢	幹活
做嘢好好心機	做事很細心
做嘢好兒戲	幹活很不紮實
捉	抓
竹	竹子
粥	稀飯
捉波子棋	下跳棋
竹笪	竹蓆
捉到	抓到
捉到正	抓個正著
捉雞腳	挑毛病
捉緊	抓緊
竹篙	竹竿
竹枝	小竹子
捉字蝨	摳字眼兒
竹戰	打麻將
捉住	抓住
捉棋	下棋
捉棋比賽	下棋比賽
竹纈	竹節
粥舖	粥品店
竹紗	府綢
竹紗衫褲	府綢衣服
捉實	抓緊
竹升	假洋鬼子
竹升	竹槓
竹升仔	假洋鬼子
竹升妹	假洋妞
捉痛腳	揭短
捉兒人	捉迷藏
捉魚	捕魚
濁	嗆
贖	找
濁親	噎著
贖錢	找錢
俗到死	俗不可耐
逐家逐戶	一家一家
逐家逐戶噉	一家一家地
俗骨	俗氣
俗語話	俗話說
俗語話齋	俗話說
俗語有話	正如俗話所說
舂	杵
鐘	時鍾
中餐	午飯
鐘點	幫傭
鐘點工	幫傭
鐘點女傭	幫傭
中更	中班
忠角	正派
舂吓舂吓	踉蹌
中學雞	中學生
中褸	中大衣
舂落去	墜下去
舂落嚟	墜下來
鍾唔鍾意	喜不喜歡
中文堂	中文課
中女	老剩女
終須	終歸
中小企	中小型企業
鐘數	時間
盅頭飯	蒸飯
舂瘟雞	走路不穩
鍾意	喜歡
粽	粽子
總係	總是
總好過…	總比…好
總站	起點站
總掣	總開關
總言之	總之
縱	寵
中招	中計
中咗邪	著了邪
縱壞	寵壞
種禾	種稻子
仲	還
仲弊	還要糟糕
仲大鑊	更糟糕
仲加	更加
仲兼	還
仲估	還以為
仲喺度	還在這兒
仲係	還是
仲係噉	還是這樣子
仲好	還要好
仲唔得	還不行
仲唔係	還不是
仲未	還沒
仲未掂	還沒辦妥
仲未到	還沒到
仲未攪掂	還沒辦妥
仲未夠班	還不夠資格
仲未執好	還沒收拾好
仲冇咁嬲	還不如…
仲生	還活著
仲使講	還用說
仲使問	還用問
仲細	還小
仲想點	還想怎樣
仲話	還說
仲還	還是
仲有	還有
仲有冇	還有沒有
仲要	還要
豬腸粉	熟米粉卷兒
豬兜	蠢鈍
豬竇	豬窩
豬腳	豬蹄子
豬膏	豬油
朱古律	巧克力
朱古力	巧克力
朱古力新地	巧克力聖代
朱古力碎	巧克力豆
朱古力碎曲奇	巧克力片餅乾
朱古力雪糕	巧克力冰淇淋
豬公	公豬
豬紅	豬血
豬紅粥	豬血粥
豬紅湯	豬血湯
豬踭	豬肘子
豬踭肉	豬肘子
豬雜	豬雜碎
珠仔	小珠兒
豬仔	小豬
豬仔	苦力
豬仔包	短法國麵包
珠仔豆	豇豆
豬仔客	人口販子
豬嘴	防毒面罩
豬欄	豬圈
豬柳	豬菲力
豬脷	豬舌頭
豬籠入水	喩錢財從多方面進來
豬嘜	愚蠢
豬乸	母豬
豬乸菜	莙薘菜
豬扒	豬排
豬扒包	豬排包
豬扒飯	豬排飯
豬朋狗友	壞朋友
豬潲	豬食
豬手	豬前腿
豬頭柄	傻子
豬頭骨	無利可圖的事
豬頭嘜	傻子
豬橫脷	豬胰
豬潤	豬肝
朱義盛	贗品
朱義盛貨	贗品
豬腰	豬腎
煮重米	告狀
煮到埋嚟先食	吃現成兒
煮飯	做飯
煮飯仔	做飯
煮飯仔	過家家
煮飯婆	妻子
煮燶飯	煮煳了飯
煮唔腍	煮不爛
煮米	告狀
煮腍	煮爛
煮燶	燒煳
煮燶咗	燒煳了
煮食	煮飯吃
煮宵夜	煮夜宵
煮餸	做菜
主人婆	女主人
住客	房客
住喺	住在
住响	住在
住落嚟	住下來
專登	故意
專門店	專賣店
專同…詏頸	專門跟…抬槓
轉吓眼	一轉眼
轉行	轉業
轉性	學乖了
轉軚	轉向
轉頭	回頭
轉頭見	回頭見
轉頭嚟過	回頭再來
轉得好衡	轉得很快
轉工	轉換新的工作
轉左	左轉
鑽撈	鑽石勞力士錶
轉右	右轉
啜	吸
啜嘴	親嘴
啜嘴	親
啜面珠	吻臉蛋
啜奶	吃奶
啜入	吸進
絕情	無情
絕橋	妙計
絕世好橋	妙計
卡	克拉
卡	車廂
卡士	演員陣容
卡通片	動畫電影
卡位	座位
卡罅	縫兒
咔咔聲	笑聲
咔咔笑	哈哈大笑
楷	瓣兒
咭	卡
咭紙	硬卡紙
咭片	名片
咭數	卡帳
交叉	叉
靠	依靠
靠唔住	靠不住
溪錢	紙錢
契	契約
契	認乾親
契弟	混蛋
契家佬	情夫
契家婆	情婦
契哥	乾哥哥
契仔	乾兒子
契姐	乾姐
契媽	乾媽
契妹	乾妹
契乸	乾媽
契女	乾女兒
契娘	乾媽
契細佬	乾弟
契爺	乾爹
禁	耐
禁打	經打
禁等	夠等的
禁攪	做不完
禁著	耐穿
襟章	胸章
禁做	做不完
噙噙地	女性化
禁冷	耐寒
禁磨	耐磨
禁諗	費腦筋
禁死	不易死
禁色	不褪色
禁睇	耐看
禁聽	耐聽
禁熱	耐熱
禁用	耐用
𢫏	摑
𢫏	蓋
𢫏斗	倒閉
𢫏檔	倒閉
𢫏賭	抓賭局
𢫏蓋	蓋蓋子
𢫏國旗	死了
𢫏旗	倒閉
𢫏旗	死了
𢫏佢一巴掌	摑他一個耳光
𢫏你一巴掌	摑你一個耳光
𢫏被	蓋被子
𢫏一巴掌	摑一個耳光
擒樹	爬樹
擒	爬
擒青	匆忙
擒高擒低	爬上爬下
琴朝	昨天早上
擒擒青	匆忙
擒擒青青	匆匆忙忙
擒騎	愛攀緣的
蠄蟝	癩蛤蟆
蠄蟧	蜘蛛
蠄蟧絲網	蜘蛛網
琴晚	昨晚
琴晚黑	昨晚
擒上	爬上
擒上去	爬上去
擒上樹	爬上樹
琴日	昨天
妗母	舅媽
妗婆	舅奶奶
compute	計算機科學
勤力	用功
近路	近道
鯁	噎
鯁親	嗆著
鯁頸	噎
鯁骨	卡了魚刺
鯁唔落	嚥不下
鯁死	噎死
掯	有本事
掯	醇厚
扱	罩
吸塵機	吸塵器
扱得好冚	蓋得很嚴
扱實隻蓋	把蓋子蓋好
扱印	蓋章
及	咬
及得上	比得上
cut	剪斷
咳	咳嗽
cut線	掛斷
摳	調
溝	勾引
溝仔	追男人
摳摳埋埋	混合在一起
摳唔埋	合不來
摳埋	混合在一起
溝女	泡妞
扣針	別針
扣唔埋	扣不上
球證	裁判
求求其其	不認真
求其	隨便
求先	剛才
舅父	舅舅
舅公	舅爺
舅仔	小舅子
茄喱啡	臨時演員
cash	現金
茄	茄子
茄瓜	茄子
茄汁	番茄醬
茄牛通	番茄牛肉通心粉
騎膊馬	騎在肩膀上
騎劫	劫持
騎樓	陽台
騎呢	古怪
騎呢𧊅	怪人
騎呢𧊅	雨蛙
騎牛搵馬	騎驢找馬
K場	卡拉OK店
K房	卡拉OK包廂
K金	開金
K歌	卡拉OK歌
K仔	氯胺酮
畸士	案子
奇	奇怪
蜞乸	螞蟥
奇難雜症	疑難雜症
奇異果	彌猴桃
企	站
企出嚟	站出來
企定	站穩
企定定	站穩穩的
企定腳	站住
企到腳軟	腳都站軟
企街	妓女
企櫃面	掌櫃
企起嚟	站起來
企起身	站起來
企住	站住
企企理理	整整齊齊
企理	整潔
企領	竪領
企唔住腳	站不住腳
企唔穩	站不穩
企埋邊	靠邊站
企埋嚟	站過來
企埋一邊	靠邊站
企埋一齊	站在一起
企歪啲	借光
企硬	站定
企心邊	豎心旁
企身	立式
企身煲	立式瓦鍋
企身櫃	大衣櫃
企堂	跑堂的
企堂	罰站
企位	站立的位子
企人邊	單人旁
劇	電視劇
屐	木屐
cam	攝像機
chem	化學
claim	申報
claim保險	索取保險金
claim翻	報銷
claim稅	提出減免稅款
cancer	癌
拘執	計較
佢	他
佢哋	他們
佢哋嘅	他們的
佢哋自己	他們自己
佢哋自己嘅	他們自己的
佢份人	他這個人
佢嘅	他的
佢個人	他的為人
佢隻嘢	他這個傢伙
佢自己	他自己
佢自己嘅	他自己的
佢兩個	他倆
鏹	硫酸
鏹水	硫酸
畸卡	人的笑聲
畸卡咁笑	嘻哈地笑
畸畸卡卡	笑聲
click	點擊
撠	卡
撠親	絆倒
撠腳	繞腳
撠住	卡住了
撠住咗喇	卡住了
撠手	棘手
撠手撠腳	礙手礙腳
click入去	點進去
鉗	鉗子
傾	凱
傾	談
傾得	健談
傾得埋	談得來
傾掂	談好
傾電話	聊電話
傾偈	聊天
傾公事	談公事
傾吓	談一下
傾吓偈	聊聊天
傾吓傾吓	正說著
傾閒偈	閒聊天
傾陣	聊一會兒
傾傾吓	正談著
傾唔掂	談不攏
傾唔掂數	談不攏
傾唔落去	談不下去
傾唔埋	談不攏
傾密偈	談心
傾生意	談生意
傾世界	聊天兒
傾心事	談心
傾成	談得成
keep	保存
keep	盯
喼弗	減肥
揭盅	揭曉
cute	可愛
橋	辦法
蹺	巧
蹺妙	巧妙
橋凳	長凳
橋段	劇情
繑	纏
繑火牛	繞變壓器
繑口	拗口
繑起對手	交叉著雙手
繑住手	交叉著雙手
繑冷	纏毛線
繑脷	拗口
繑埋雙手	交叉雙手
繑手	交叉雙手
繑絲邊	絞絲旁
繑線	繞線
call	叫
call白車	叫救護車
call車	叫車
call機	傳呼機
call機肉	大肚皮
quali	資歷
call台	傳呼台
call人	叫人
搉	敲
搉頭殼	敲腦袋
確係	的確是
con	隱形眼鏡
cool	帥
箍	捆緊
箍煲	補救
箍到實	勒得很緊
箍頸	勒脖子
箍頸黨	劫匪
箍牙	牙齒矯正
箍臣	軟墊子
曲	彎曲
曲	曲子
曲架狗	可卡犬
曲奇	小甜餅
曲奇麵團	餅乾麵團
藭	嘟嚕
窮到燶	一貧如洗
窮到塌地	一貧如洗
𡃈	圈
虧柴	身體潺弱的人
葵瓜子	葵花子
葵扇	黑桃
坤	騙
坤掂佢	哄好他
裙	裙子
裙腳仔	媽寶
裙腳妹	近身妹
群埋	結交
纊	絆
纊親	絆著
纊住	拴住
纊爛	剮破
纊掕	串
纊埋	扣上
拳	拳頭
拳手	划拳
啦啦隊	拉拉隊
啦啦隊隊長	拉拉隊隊長
啦啦隊長	拉拉隊長
啦啦隊員	拉拉隊員
啦嗎	了吧
啦嘛	嘛
拉士	最後
揦	拿
揦口揦面	苦著臉
揦住	抓住
揦揦西西	馬馬虎虎
揦脷	過鹹
揦脷	非常昂貴
揦埋口面	苦著臉
揦西	馬虎
揦手	難辦
揦手唔成勢	棘手
揦屎上身	自找麻煩
喇	了
罅	縫隙
啦啦亂	亂糟糟
啦啦聲	迅速
啦啦聲去啦	快一點去吧
啦啦林	迅速
揦鮓	髒
揦鮓麵	雜碎麵
孻	末尾
拉	抓
拉布	冗長辯論
拉柴	死
拉親	拉傷
拉尺	捲尺
拉大纜	拔河
拉低	拉下
孻仔	老兒子
拉埋天窗	結婚
孻屘	最後
孻女	老閨女
拉牛上樹	趕鴨子上架
拉臣	執照
拉手仔	談戀愛
拉人	抓人
拉油	過油
𦧺	舔
𦧺嘴脣	舔嘴脣
𦧺手指	舔手指
𦧺屎窟	拍馬屁
癩	疥瘡
癩螆	疥蟲
賴貓	賴皮
賴貓君	無賴
瀨	倒
賴	遺留
賴低	留下
瀨粉	圓條狀粗粉條
賴咗	丟了
賴尿	尿床
賴尿蝦	經常尿床的小孩
賴尿蝦	蝦蛄
賴死	賴著不走
賴屎	大便失禁
嘞	了
攬	摟
欖	橄欖
籃	籃子
攬belt	繫上安全帶
攬炒	玉石俱焚
攬到實	抱得很緊
攬到實晒	抱得很緊
攬頸	搭肩
欖角	橄欖
攬枕	抱枕
攬住	摟著
攬住死	玉石俱焚
攬埋死	玉石俱焚
攬埋一齊死	玉石俱焚
攬埋一嚿	抱在一起
攬實	抱緊
欖豉	橄欖
攬頭攬頸	摟摟抱抱
欖核	橄欖核兒
藍啤梨	藍莓
欖球	橄欖球
攬身攬勢	摟摟抱抱的
攬	圍
攬頸巾	圍圍巾
攬皮帶	束皮帶
round	圈
欄	批發店
躝	滾
躝	爬
躝開	滾開
躝屍	滾蛋
躝屍趷路	滾蛋
躝癱	流氓
讕	充
讕大方	不必要地表現出慷慨
讕得敕	揚揚得意
讕闊佬	擺闊氣
讕架勢	逞能
讕客氣	虛偽的客氣
讕盞	臭美
讕正經	假正經
讕在行	自以為很內行
讕叻	臭美
讕惡爺	自以為很了不起
讕使	揮霍
讕神秘	故作神秘
讕醒	驕傲自大
讕熟落	套近乎
讕殷勤	獻殷勤
讕有寶	自以為是
讕有嘢	自恃有本事
攔河	欄桿
欄河	欄杆
懶理	少管
懶佬	懶漢
懶佬工夫	容易幹的活兒
懶佬鞋	方便鞋
懶佬椅	躺椅
懶人多屎尿	藉故偷懶
爛湴	爛泥
爛打	好鬥
爛賭	好賭
爛賭二	嗜賭的人
爛飯	軟飯
爛瞓	貪睡
爛瞓豬	懶蟲
爛gag	冷笑話
爛鬼	流氓
爛鬼	破爛
爛鬼嘢	破爛貨
爛滾	好色
爛喊	愛哭
爛喊貓	愛哭的孩子
爛口	愛說下流話
爛口	粗話
爛仔	流氓
爛酒	好喝酒
爛酒佬	醉鬼
爛賤	不值錢
爛咗	壞了
爛佬	惡棍
爛尾	沒有好結局
爛尾樓	未完成的樓房
爛泥扶唔上壁	癩狗扶不上牆
爛女	女流氓
爛牙	蟲牙
爛平爛賤	廉價
爛蒲	貪玩
爛衫	破爛的衣服
爛身爛勢	衣服破爛
爛市	滯銷
爛市貨	滯銷貨
爛食	貪吃
爛數	爛帳
爛熟	十分熟
爛船都仲有三斤釘	瘦死的駱駝比馬大
爛船都有三斤釘	瘦死的駱駝比馬大
爛船仲有三斤釘	瘦死的駱駝比馬大
爛銅爛鐵	破銅爛鐵
爛玩	貪玩
爛癮	癮頭大
爛蓉蓉	破爛
冷	毛線
唥	鈴聲
唥鐘	鈴
唥鐘	鬧鐘
唥唥	鈴鈴聲
冷襪	毛襪
冷帽	毛線帽
冷衫	毛衣
冷手襪	毛線手套
冷	寒冷
冷親	著涼
冷到硬咗	凍僵了
冷飯	剩飯
冷飯菜汁	殘羹剩飯
冷氣	空調
冷氣機	空調機
冷巷	過道
冷手執個熱煎堆	冷鍋裡撿了個熱栗子
冷天	冬天
擸	收攏
擸	邁
擸光晒	搜刮一空
擸擸炩	鋥亮
擸炩	鋥亮
擸埋	收起來
擸網頂	取得第一名
擸平嘢	搶購便宜貨
擸晒網頂	取得全部第一名
擸一眼	掃一眼
擸嘢	搶購東西
蠟青	瀝青
蠟青馬路	柏油馬路
臘腸	香腸
立定心水	下定決心
立雜	雜亂
立雜嘢	亂七八糟的東西
立立雜雜	亂七八糟
立例	立法
臘味	臘製食品
垃圾篸	簸箕
垃圾槽	垃圾滑道
垃圾蟲	亂丟垃圾的人
垃圾佬	清道夫
立心	決心
立實心腸	下定決心
𩶘魚	鯛魚
瘌痢	頭癬
瘌痢頭	頭上長疥瘡
辣辣哋	辣辣的
邋邋遢遢	骯髒
邋遢	髒
邋遢貓	泥猴兒
邋遢嘢	髒東西
辣魚多	辣魚三明治
撈	外省的
撈仔	外省來的男孩子
撈佬	外省人
撈妹	外省來的女孩子
撈女	外省來的女孩子
撈鬆	外省人
撈頭	外省人
戾	擰
戾偈	棘手
戾狗邊	反犬旁
戾轉個頭	回過頭來
戾轉身	轉過身去
戾轉頭	回過頭來
戾埋片面	背過臉去
戾身就走	轉身就跑
禮拜	星期
禮拜六	星期六
禮拜尾	週末
禮拜五	星期五
禮拜三	星期三
禮拜四	星期四
禮拜一	星期一
禮拜日	星期日
禮拜二	星期二
禮衣邊	衣字旁兒
矋	瞟
荔枝造	荔枝旺季
荔枝核	荔枝核兒
例牌	照例
利是	紅包
利是錢	紅包
利是封	紅包封套
例湯	普通湯
簕	刺
簕竇	難商量的
冧	哄
冧	喜歡
冧	蕾
冧巴	號碼
冧巴溫	第一號
冧歌	抒情歌
冧宮頭	寶蓋頭
冧酒	朗姆酒
冧篷頭	寶蓋頭
冧	倒
冧檔	垮台
冧咗	死了
冧樓	樓房倒塌
冧屘	後來
冧山泥	山崩
冧友	殺人
淋	澆
淋花	澆花
臨瞓	睡前
臨瞓前	睡前
臨急臨忙	臨時應付
臨急抱佛腳	臨時抱佛腳
臨記	臨時演員
淋紅油	恐嚇
林林沈沈	烏七八糟
臨屘	最後
臨屘香	到最後才失敗
臨屘衰	到最後才失敗
林沈	拉雜
林沈嘢	不三不四的事
淋屎	潑糞
臨時臨急	臨時應付
淋油	潑油漆
㨆	堆
㨆班	蹲班
掕	串
笠	哄
笠	套
笠	竹簍
笠到掂晒	哄得服服帖帖的
笠翻	套上
笠緊	套得很嚴實
笠記	體恤
笠高帽	吹捧
笠遮	收傘
笠住	蓋著
笠落去	套下去
笠衫	汗衫
笠細路仔	哄小孩
笠實	套得很嚴實
笠實晒	套得很嚴實
笠水	害怕
笠頭	套頭
立立亂	亂糟糟
立亂	亂
甩	脫落
甩底	失敗
甩底	失約
甩肺	半死
甩褲	掉褲子
甩骹	脫臼
甩鞋帶	鞋帶鬆了
甩質	糟糕
甩嘴	接不上嘴
甩咗	掉了
甩咗鞋帶	鞋帶鬆了
甩甩離	快掉了
甩甩離離	快掉了
甩難	脫困
甩牙	牙掉了
甩牙骹	下頜骨關節脫臼
甩皮甩骨	缺頭少尾的
甩身	脫身
甩身唔到	脫不了身
甩手	脫手
甩色	掉色
甩鬚	丟臉
甩頭髮	脫髮
甩頭甩骨	散了架
甩拖	失約
摟	披
褸	大衣
褸袋	大衣口袋
摟翻	披上
摟翻件褸	把大衣披上
摟席	當乞丐
褸裙	大衣式連衣裙
褸屘	後來
樓	公寓
嘍	邀約
嘍口	口吃
嘍口佬	結巴
流	差
流鼻水	流鼻涕
留低	留下
樓花	預售屋
留翻	留下
流口水	低劣
流口水	垂涎三尺
留响屋企湊仔	留在家裡照顧孩子
樓契	房產證
流流	正當…的時候
流流長	時間長
流料	假消息
留落	留下
流落嚟	流下來
流馬尿	流淚
樓盤	房子
流晒口水	垂涎三尺
流嘢	次品
留醫	住院
樓宇	樓房
柳	裹脊
漏	落
漏低	落下
漏底	露餡
漏雞	錯過機會
漏氣	性子慢
漏氣	跑氣
漏咗	忘了
漏罅	漏縫兒
漏晒餡	穿幫了
漏夜	連夜
漏夜做	連夜幹活
漏夜入城	連夜進城
咧氣	狼狽
咧晒氣	狼狽不堪
哩啡	凌亂
籬	篩子
label	標簽
厘士	花邊
梨	梨
嚟	來
嚟遲	來晚
嚟遲咗	來晚了
嚟得切	來得及
嚟得啱	來得正好
厘戥	戥子
離地	脫離平民百姓
嚟到	來到
嚟㗎	啊
嚟緊	將會
嚟自	來自
嚟唔切	來不及
嚟唔得切	來不及
離唔開	離不開
嚟呢度	來這裡
嚟神	來勁兒
厘印	印花稅
厘印費	印花稅
厘印稅	印花稅
離遠	離得遠
理	管
裏	裏子
𢃇	帆
理氣	好管閒事的
理唔掂佢	管不了他
理你邊個	管你是誰
理你咁多	管你那麼多
理數	管帳
利	鋒利
脷	舌頭
利口唔利腹	好吃但對身不益
利害	厲害
脷尖	舌尖
脷苔	舌苔
叻	聰明
叻過龍	聰明反被聰明誤
叻仔	聰明人
叻唔切	愛出風頭
叻女	聰明的女人
舐	舔
舐嘴	舔嘴脣
僆	年輕
僆	黑社會人員
僆仔	小子
僆琼	小子
僆模	小模
僆妹	小丫頭
僆妹	小女孩
僆妹仔	女孩子
僆女	少女
靚	美
靚波	好球
靚車	好車
靚貨	好貨
靚歌	好聽的歌
靚仔	美男子
靚仔靚女	俊男美女
靚仔有型	英俊瀟灑
靚溜	漂亮
靚靚	漂亮
靚女	美女
靚女咗	變漂亮了
靚衫	漂亮衣服
靚湯	好湯
靚嘢	好東西
靚嘢唔平	好貨不便宜
靚樣	美貌
零	多
靈擎	靈驗
領當	上當
領𧘹	領帶
領嘢	上當
𦧲	吐
𦧲翻出嚟	吐出來
𦧲飯	吐飯
𦧲飯應	立刻答應
𦧲蔗渣	吐甘蔗渣
騾	騾子
雷公	雷
雷公鑿	苦瓜
雷公蛇	鰐蜥
驢仔	苦工
鐳射	激光
鐳射唱機	激光唱機
鐳射唱片	激光唱片
鐳射影碟	激光錄像片
裏便	裡面
裏底	裡面
鋁罐	罐頭
旅行喼	旅行箱
旅遊巴	遊覽車
旅遊巴司機	遊覽車又稱觀光車
累	害
累到	害得
累己累人	害人害己
累死	害死
累人累物	害苦了別人
掠錢	騙錢
掠水	騙錢
略略	稍微
噒	啃
噒骨	啃骨頭
噒諄	羅嗦
噒欖核	啃橄欖核
輪	權證
輪	排隊
輪	次
輪	陣子
輪更	輪班
輪候	排隊等候
輪住	輪流
輪住值班	輪流值班
輪住嚟	挨個兒來
輪呔	輪胎
論盡	麻煩
論盡	龍鍾
娘	老套
娘柄	老套
糧	薪水
涼茶	清涼茶
涼茶舖	賣清涼茶的店
涼粉	燒仙草
涼粉草	仙草
涼瓜	苦瓜
涼果	醃製果子
涼氣	性涼
涼浸浸	涼嗖嗖
涼水	清涼飲料
涼爽	涼快
兩便	兩邊
兩度散手	兩下子
兩份	一起
兩腳一伸	死亡
兩個字	十分鍾
兩公婆	夫妻倆
兩兄妹	兄妹兩個人
兩毫半	兩毛五分
兩仔乸	母子倆
兩仔爺	父子倆
兩姊妹	姐妹倆
兩摳	混合在一起
兩老	老倆口
兩母女	母女倆
兩眼濕濕	淚汪汪
兩睇	不一定
兩頭趯	兩邊竄
兩頭走	走來走去
兩頭唔到岸	兩頭落空
兩頭唔受中間受	夾在中間受氣
兩頭望	東張西望
兩頭蛇	兩面派
兩頭揗	走來走去
律師紙	律師證明
律師樓	律師事務所
叻幣	新加坡貨幣
叻埠	新加坡
叻架	清漆
力谷	大力吹噓
力行雞	來亨雞
力捧	極力吹噓
廉記	廉政公署
連隨	隨即
連結	鏈接
連氣	一連
連氣幾日	一連幾天
蓮子蓉口面	笑容燦爛
連埋	連同
蓮蓉	蓮茸
練波	練球
練眼界	練眼力
軨	輪輞
軨蓋	轂蓋
玲瓏浮突	精緻玲瓏
炩	鋥亮
炩擸擸	鋥亮
零丁	非整數
靈灰	骨灰
零零丁丁	孤零零
零舍	特別
零舍唔同	特別不一樣
靈水	聰明
零星落索	零零落落
靈醒	聰明伶俐
令到	使
𨋢	電梯
𨋢槽	電梯井
𨋢口	電梯口
𨋢門	電梯門
纈	結
撩	挖
撩鼻屎	挖鼻孔
了哥	八哥
撩耳	掏耳朵
撩耳仔	掏耳朵
撩耳屎	挖耳垢
撩	攪
料	人材
料	布料
料	材料
料	資料
撩牙	剔牙
撩牙罅	剔牙縫
嫽	逗
嫽到	惹得
嫽交打	找茬
嫽交嗌	挑釁
嫽嫽吓	挑起一個問題來氣人
嫽女仔	調戲女孩子
嫽是逗非	撥弄是非
嫽是非	挑撥是非
了不得	了不起
了得	了不起
囉	了
囖	籮筐
囉氣	勞神
囉囉攣	鬧
囉攣	鬧
囉柚	屁股
攞	拿
籮	斗
螺	螺螄
攞齊啲嘢	把東西收拾好
攞齊嘢	把東西收拾好
攞籌	掛號
攞車	取車
擺出嚟	拿出來
攞出嚟	拿出來
攞錢	提錢
攞彩	炫耀
攞膽	要命
攞到	拿到
攞翻	拿回
攞翻出嚟	再拿出來
攞翻公道	討回公道
攞翻去	拿回去
攞苦嚟辛	自討苦吃
攞景	取景
攞景	揶揄
攞景定贈慶	起閧
攞景贈慶	揶揄
攞個籌掛號	拿個牌兒掛號
攞過嚟	拿過來
攞起	拿起
攞去	拿去
攞走	拿掉
攞獎	獲獎
攞嚟	拿來
攞嚟攪嘅	自找麻煩
攞嚟講	扯淡
攞嚟講嘅啫	隨便說說而已
攞嚟賤	自甘下賤
攞嚟衰	自找麻煩
攞嚟睇睇	拿來看看
攞落嚟	拿下來
攞唔定主意	拿不定主意
攞命	要命
攞便宜	討便宜
攞晒彩	十分威風
攞晒翻去	全拿回去
攞威	逞威風
攞意頭	討彩頭
囉	了
𤓓	煳味
囉噃	了
𤓓味	煳味
籮	籮筐
羅	啦
籮底橙	剩貨
羅經	羅盤
羅漢腸	素粉條
羅漢齋	素什錦
螺絲	螺釘
螺絲介子	墊圈
螺絲批	螺絲起子
羅宋湯	羅宋湯
來路	外來的
來路貨	進口貨
來路嘢	洋貨
來世	來生
咯	了
落	下
落	加
落吧	泡吧
落班	下班
落簿	做記錄
落本	下本錢
落車	下車
落斜	下坡
落床	下床
落大雨	下大雨
落單	下定單
落定	下定金
落袋	放進口袋裡
落袋	進帳
落到去	一直到
落毒	下毒
落飛機	下飛機
落肥	施肥
落貨	卸貨
落街	上街
落街行吓	上街走走
落更	下班
落狗屎	下大雨
落機	下飛機
落腳	停留下來
落下面	死
落客	讓乘客下車
落口供	錄口供
落起雨嚟	下起雨來
落去	下去
落鄉	下鄉
落仔	墮胎
落酒吧	泡吧
落妝	卸妝
落足	下足
落足功夫	下足功夫
落足嘴頭	拼命遊說
落足眼力	全神貫注
落足心機	下足功夫
落注	下注
落佢面	丟他的臉
落樓	下樓
落樓梯	下樓梯
落嚟	下來
落力	賣力
落令	下令
落唔到手	下不了手
落馬	下馬
落蚊帳	把蚊帳掛起來
落臉	丟臉
落面	丟臉
落案	備案
落山	下山
落手	下手
落手落腳	親自動手
落石級	下台階
落剩	剩下
落船	上船
落雪	下雪
落雪珠	下冰雹
落雪水	下很冷的小雨
落台	下台
落糖	加糖
落堂	下課
落畫	結束放映
落夜班	下夜班
落藥	下毒藥
落藥	下藥
落鹽	加鹽
落雨	下雨
落雨溦	下毛毛雨
落雨濕濕	下雨路滑
落雨絲濕	下雨路滑
狼戾	撒野
𠺘	涮
𠺘口	漱口
𠺘口盅	漱口杯
𠺘口水	漱口水
狼	狠
狼命	狠
狼忙	匆忙
狼死	兇猛
龍頭	黑幫領袖
狼胎	狠
浪	襠
晾蚊帳	掛蚊帳
晾衫	晾衣服
晾衫架	晾衣架
撈	勞力士錶
撈	混日子
撈	混
黸	鍋燼
撈得掂	混得好
撈得好掂	混得挺好的
撈得唔錯	混得不錯
撈到風生水起	混得很好
撈到盤滿缽滿	大大撈了一筆
撈飯	拌飯
撈家	老油子
撈仔	流氓
撈汁	用菜汁拌飯
撈靜水	池獨門兒
撈亂	混淆
撈亂骨頭	水火不相容
撈亂咗	弄亂了
撈亂晒	搞混了
撈埋	伴進
撈麵	拌麵
撈拿	滑旱冰
撈女	女流氓
撈世界	混日子
撈頭	賺錢的可能
撈勻	拌均勻
佬	男人
驢	驢子
嘮嘈	大聲
蘆橘	枇杷
勞氣	動怒
勞氣	費話
爐頭	爐灶
老餅	老土
老餅	老頭
老表	表親
老襯	傻瓜
老襯	親家
老抽	濃醬油
老千	騙子
老竇	父親
老竇老母	爹媽
老竇姓乜都唔知	得意忘形
老點	作弄
老頂	老闆
老定	鎮定
老到巢皮咪𠵼	皮皺皺的
老番	老外
老翻	翻版
老番冬	聖誕節
老番涼茶	啤酒
老番睇榜第一	倒數第一
老火	慢火
老火靚湯	久煮的好湯
老火湯	久煮的湯
老虎公	公老虎
老虎蟹	天塌下來
老虎蟹	旭蟹
老虎仔	小老虎
老虎乸	母老虎
老更	更夫
老舉	妓女
老姑婆	老姑娘
老倌	名伶
老公仔	老公
老鬼	老人
老鬼	老練的人
老坑	老頭
老坑公	老頭
老坑婆	老太婆
老行專	老行家
老友鬼鬼	老朋友
老積	老成
老積仔	老成的少年
老左	香港左派
老作	胡說
老祖	祖先
老宗	本家
老襟	連襟
老黎	吉利
老笠	搶
老貓燒鬚	老馬失蹄
鹵味	醬肉
老母	母親
老懵	老糊涂
老泥	汗垢
老嚙嚙	很老的樣子
老藕	黃臉婆
老脾	脾氣
老編	編輯
老婆餅	老婆餅
老婆仔	老婆
老散	散戶
老散	警察
老西	西裝
老細	老闆
老實講句	老實說
老死	老友
老鼠貨	賊贓
老鼠夾	捕鼠器
老鼠仔	二頭肌
老鼠拉龜	無計可施
老鼠窿	老鼠洞
老太	老太太
老土	土氣
老屈	誣衊
老友	老友
老友記	老朋友
老爺	公公
老爺車	舊車
老嘢	老傢伙
老而不	老不正經
路仔	小路
露筍	蘆筍
路數	門路
露台	陽台
look	形象
睩	瞪
碌	段
碌	滾
轆	軋
轆	輪
碌爆	透支
碌爆咭	刷爆信用卡
轆親	軋傷
睩大眼	睜大雙眼
睩大雙眼	瞪著眼睛
碌地	打滾
碌地沙	打滾
碌架床	雙層床
碌咗落嚟	滾了下來
碌咭	刷卡
轆軨	輪輞
轆軨蓋	轂蓋
碌落去	摔下去
碌落嚟	摔下來
睩眼	瞪眼睛
碌士	筆記
碌柚	柚子
戮	踐踏
淥	燙
淥親	燙傷
淥親手指	燙傷了指頭
錄低	錄下
綠豆水	綠豆湯
六個字	三十分鍾
淥個麵	泡一個麵吃
六角匙	內六角扳手
陸軍裝	平頭
六國大封相	吵鬧
六張幾	六十多歲
淥麵	泡麵
綠帽	綠帽子
淥熟	燙熟
淥熟晒	被開水泡熟了
綠衣	警察
錄影機	錄像機
淥魚片	涮魚片
窿	孔
窿仔	小洞
窿路	門路
窿窿罅罅	犄角旮旯
籠	籠子
龍床不如狗竇	金窩銀窩不如自己的狗窩
龍穿鳳	發跡
龍躉	石斑魚
龍鳳鈪	龍鳳鐲
龍鳳胎	雙胞胎
隆胸	豐乳
龍舟節	端午節
龍精虎猛	生龍活虎
龍脷	鰨
龍脷柳	鰨魚菲力
龍脷魚	鰨
籠𨋢	施工升降機
龍門	球門
龍牙豆	菜豆
龍船	龍舟
龍船襪	踝襪
槓	箱子
攣	彎
攣捐	彎彎曲曲
攣曲	彎曲
攣毛	鬈髮
亂嚟	胡來
亂龍	亂
亂諗	亂想
戀糖	黏糖
聯	縫
聯翻粒鈕	釘上釦子
聯幾針	縫幾針
聯衫	縫衣服
聯一個袋	縫一個口袋
聯一脫衫	做一套衣服
亂扠	亂塗
亂抄	亂翻
亂車	胡吹
亂車廿四	亂吹一氣
亂趯	亂跑
亂揈	揮霍
亂揈錢	揮霍
亂咁掉	亂扔
亂咁吠	胡說八道
亂咁舂	亂闖
亂咁嚟	亂來
亂咁鬧人	動不動就罵人
亂咁諗	胡思亂想
亂咁諗嘢	胡思亂想
亂咁噏	胡說
亂咁食嘢	亂吃東西
亂講嘢	胡說八道
亂估	亂猜
亂㗾	瞎起鬨
亂撞	亂闖
亂立立	亂糟糟
亂諗嘢	胡思亂想
亂噏	胡說
亂噏廿四	胡說八道
亂噏嘢	亂說話
亂晒大龍	亂七八糟
亂晒坑	亂了套
亂食嘢	亂吃東西
亂喐	亂動
唔	不
唔畀面	不給面子
唔出得聲	說不出話
唔出聲	不吭聲
唔似	不像
唔似樣	不像樣
唔清楚	不清楚
唔切	來不及
唔錯	不錯
唔睬佢	不理他
唔打得都睇得	中看不中用
唔單止	不但
唔單止噉	不僅如此
唔搭界	沒關係
唔抵	不忿
唔抵	吃虧
唔抵幫	不值得幫忙
唔抵得	眼紅
唔得	不行
唔得切	來不及
唔得掂	不得了
唔得閒	忙
唔得罪得	得罪不起
唔等使	無益
唔嗲唔吊	無所謂
唔對辦	不符合樣品
唔對路	不對勁
唔掂	不行
唔掂諗到掂為止	有事好商量
唔定	說不定
唔定性	淘氣
唔多	不多
唔多	不大
唔多似	不大像
唔多掂	不大妥當
唔多好	不大好
唔多唔少	或多或少
唔多妥	不大妥當
唔多妥	不大舒服
…唔到	…不了
唔到你	輪不到你
唔到你唔…	不由得你不…
唔到你唔信	由不得你不信
唔道德	不道德
唔化	固執
唔化算	不划算
唔發市	沒人光顧
唔忿	不服氣
唔忿氣	不服氣
唔忿老	不服老
唔方便	不方便
唔合	合不來
唔計帶	不在意
唔敢	不敢
唔緊要	不要緊
唔夠	不夠
唔夠埞方	地方不夠
唔夠瞓	睡眠不足
唔夠薑	沒膽量
唔夠喉	不夠
唔夠喉	不夠
唔夠佢打	打不過他
唔夠佢鬥	鬥不過他
唔夠佢爭	搶不過他
唔夠佢嚟	比不過他
唔夠quali	不夠格
唔夠力	力氣不夠
唔夠老友	不夠朋友
唔夠你鬥	鬥不過你
唔夠皮	不夠
唔夠使	不夠花
唔夠攝牙罅	不夠塞牙縫兒
唔記得	忘記
唔記得咗	忘了
唔啹	不忿
唔見得光	見不得光
唔見得人	見不得人
唔見棺材唔流眼淚	不見棺材不落淚
唔見咗	不見了
唔經唔覺	不知不覺
唔該	請
唔該	謝謝
唔該借歪	借光
唔該晒	謝謝
唔覺	不覺得
唔覺眼	沒注意
唔覺意	沒留意
唔高興	不高興
唔公平	不公平
唔怪得	怪不得
唔怪乎	怪不得
唔怪之得	怪不得
唔關你事	事情跟你無關
唔關我事	與我無關
唔關…事	與…無關
唔關事	不相干
唔慣	不習慣
唔過得骨	過不了關
唔過得眼	看不慣
唔過得意	過意不去
唔鹹唔淡	有口音
唔行得	走不了
唔行得開	走不開
唔行得埋	合不來
唔喺度	不在
唔喺度	去世
唔喺屋企	不在家
唔係	不是
唔係	不然
唔係呀嘛	真的嗎？
唔係呀話	不會吧？
唔係噉話	哪裡哪裡
唔係噉話，你過獎喇	哪裡，哪裡，你過獎了
唔係嘅話	不然的話
唔係幾	不大…
唔係幾似	不大像
唔係啩	不是吧
唔係好合	不大合得來
唔係就	否則
唔係路	不對勁
唔係手腳	不是對手
唔係嘢少	不簡單
唔合法	不合法
唔合理	不合理
唔合眼緣	看不順眼
唔合適	不合適
唔吼斗	不想要
唔去得	去不了
唔响度	不在
唔興	不流行
唔可能	不可能
唔可以	不可以
唔開心	不高興
唔開胃	倒胃口
唔好	不好
唔好得去邊	好不到哪裡去
唔好口	得罪人
唔好老脾	脾氣差
唔好手腳	有偷竊行為
唔好食	不好吃
唔好睇	不好看
唔好聽	不好聽
唔好飲	不好喝
唔好意思	不好意思
唔好意頭	不吉利
唔盞	不好
唔爭在	不差
唔習慣	不習慣
唔制	不肯
唔制得過	划不來
唔走得	跑不了
唔…就假	不…才怪呢
唔…就假嘅	不…才怪呢
唔…就有鬼	不…才怪呢
唔…就有鬼囉	不…那就很奇怪
唔聚財	有病
唔著襪	不穿襪子
唔著	不對
唔准	不准
唔知	不知道
唔知醜	沒羞
唔知點解	不知道為什麼
唔知道	不知道
唔知好醜	不知好歹
唔知好嬲定好笑	啼笑皆非
唔知死	不知天高地厚
唔止	不但
唔止…仲…	不但…還…
唔止…仲…添	不但…還…
唔志在	不在乎
唔至於	不至於
唔值得	不值得
唔正常	不正常
唔阻咁多位	不妨礙各位
唔阻你	不打擾了
唔再	不再
唔在講	不但
唔做	不幹
唔鍾意	不喜歡
唔中用	不管用
唔重要	不重要
唔禁	不耐久
唔禁打	不經打
唔禁等	禁不起等
唔禁著	不耐穿
唔禁撞	不禁碰
唔近	不近
唔及得	比不上
唔及得人	比不上別人
唔嚟得	來不了
唔理	不管
唔理三七廿一	不顧一切
唔叻得去邊	聰明不到哪裡去
唔論	不論
唔落得手	下不了手
唔撈	不幹了
唔老黎	不吉利
唔明	不懂
唔挐耕	毫不相干
唔難	不難
唔能	不能
唔捱得	捱不了
唔捱得苦	吃不了苦
唔啱	不對
唔啱嘴形	合不來
唔啱著	不合穿
唔啱傾	談不攏
唔啱規矩	不按規矩
唔啱路	不順路
唔啱牙	合不來
唔啱心水	不合心意
唔啱數	數目不對
唔啱睇	不適合看
唔啱聽	不中聽
唔啱用	不合用
唔安樂	心裡不安
唔耐	不久
唔耐煩	不耐煩
唔安全	不安全
唔怕	不怕
唔怕醜	不害羞
…唔晒	…不完
唔三唔四	不正經
唔生性	不懂事
唔使	不用
唔使慌	不要怕
唔使慌	別指望
唔使計	別說了
唔使咁火滾	用不著那麼生氣
唔使咁謙噃	不用那麼謙虛啦
唔使驚	不要怕
唔使講	不用說
唔使客氣	不用客氣
唔使恨	別想
唔使找	不用找
唔使知	不用管
唔使指擬	別指望
唔使做	不用工作了
唔使住	暫且不用
唔使拘	別客氣
唔使唔該	不謝
唔使問阿貴	還用問？
唔使送呀	不用送了
唔使一陣	不久
唔使憂	不用愁
唔實際	不實際
唔受得	受不了
唔捨得	捨不得
唔死都冇用	活著也浪費空氣
唔錫身	不怕死
唔聲	不說話
唔聲唔聲，嚇你一驚	不鳴則已一鳴驚人
唔衰得	好勝
唔衰攞嚟衰	沒事找事
唔需要	不需要
唔垂意	沒注意
唔信	不相信
唔相信	不相信
唔想	不想
唔識	不會
唔識	不認識
唔識唱歌	不會唱歌
唔識解	不明白
唔識個醜字點寫	不知羞恥
唔識個死字點寫	不顧危險
唔識字	不識字
唔識做	不會幹
唔識做	不識相
唔識轉彎	不靈活
唔識佢	不認識他
唔識路	不認得路
唔識死	不知天高地厚
唔識衰	不知好歹
唔識睇	看不懂
唔識聽	聽不懂
唔食得	不能吃
唔食雜	不吃葷
唔食力	吃不住勁
唔少	不少
唔少得	少不了
唔小心	不小心
唔騷	不理
唔熟行	外行
唔熟性	不懂事
唔舒服	不舒服
唔輸蝕	不比別人差
唔聽佢笛	不聽他的
唔聽佢支死人笛	不聽他發號施令
唔聽你笛	不聽你那套
唔聽佢笛	不聽他那套
唔聽我笛	不聽我那套
唔聽你支笛	不聽你那套
唔聽佢支笛	不聽他那套
唔聽我支笛	不聽我那套
唔妥	不妥當
唔通	難道
唔通氣	不知趣
唔通…咩	難道…嗎
唔同	不同
唔同意	不同意
唔話得	沒說的
唔為得過	划不來
唔穩	不牢
唔work	行不通
唔會	不會
唔會嘅	不會的
唔會啩	不會吧
唔會輸蝕	不會吃虧
唔一定	不一定
唔憂	不愁
唔憂食，唔憂著	不愁吃，不愁穿
唔易做	不好辦
唔應該	不應該
唔認得	認不得
唔認數	不認帳
唔要	不要
唔要得	要不得
唔喐	不動
唔喐得	動不了
唔容易	不容易
孖	雙
孖辮	辮子
孖份	合伙
孖公仔	形影不離的人
孖仔	孿生子
孖指	六指
孖展	保證金
孖展	商人
媽媽聲	罵娘
媽咪	媽媽
孖女	孿生姐妹
孖鋪	兩人同睡一床
孖生	孿生
孖生仔	雙胞胎
孖胎	雙胞胎
孖膶腸	厚嘴唇
孖煙囪	四角褲
孖煙通	四角褲
孖葉	手銬
媽姐	女傭人
嫲	奶奶
麻包袋	麻袋
麻煩晒	真是太麻煩您了
麻鬼煩	很麻煩
麻雀	麻將
麻雀腳	打麻將的伴兒
麻甩	麻雀
麻甩鬼	缺德鬼
麻甩仔	小色鬼
麻甩佬	缺德鬼
麻甩妹	潑辣貨
麻甩女	潑辣貨
麻利	精明能幹
麻叻	精明能幹
嫲嫲	祖母
麻麻	普通
麻麻哋	湊合
麻麻啫	不怎麼樣
麻石	花崗岩
蔴油	香油
麻鷹	老鷹
碼	釘緊
馬標	賽馬票
馬場	賽馬場
碼釘	螞蟥釘
馬伕	淫媒
馬經	賽馬資料
馬公	公馬
馬仔	小馬
馬仔	狗腿子
馬仔	薩其馬
碼子	子彈
馬拉	馬來西亞
馬拉盞	蝦醬
馬檻	馬廄
馬騮	猴子
馬騮戲	猴戲
馬騮戲	鬧劇
馬騮仔	小猴子
馬騮精	調皮的小孩
馬螂狂	螳螂
馬尿	淚水
碼實	釘緊
馬死落地行	隨遇而安
馬蹄	荸薺
馬蹄粉	荸薺粉
埋	靠近
埋便	裡面
埋單	死
埋單	結賬
埋堆	扎堆
埋口	愈合
埋去	走過去
埋閘	店舖關門
埋席	入席
埋嚟	過來
埋尾	收場
埋牙	交手
埋岸	靠岸
…埋晒	都
埋身	靠近
埋手	下手
埋數	算帳
埋頭	靠岸
埋頭埋腦	沉迷
埋位	入席
埋位	開始拍攝
買低	買下
買飛	買票
買吓嘢	逛街
買紮花	買束花
買樓	買公寓
買樓花	預購房屋
買落	買下了
買唔到飛	買不到票
買屋	買房子
買衫	買衣服
買宵夜	買夜宵
買少見少	越來越少
買餸	買菜
買嘢	買東西
買燕梳	投保險
賣	登載
賣白粉	販賣毒品
賣大包	大送人情
賣花讚花香	王婆賣瓜
賣埠	出口
賣貨員	售貨員
賣告白	登廣告
賣鹹鴨蛋	去世
賣口乖	耍嘴皮
賣剩蔗	剩貨
賣豬仔	賣身去做苦工
賣甩	甩
賣樓花	預售房屋
賣面光	討好
賣晒	賣光
賣生藕	灌米湯
賣相	外表
擘	張
擘	撕
擘髀	張開雙腿
擘大	張大
擘大個口	張大嘴巴
擘大個口得個窿	張口結舌
擘大口	張開嘴巴
擘大口得個窿	張口結舌
擘大喉嚨嗌	扯開嗓門拼命喊
擘大嘴	張開嘴巴
擘大眼	睜著眼
擘大眼講大話	睜眼說瞎話
擘開	張開
擘開大髀	叉開大腿
擘開對眼	睜開眼睛
擘開個口	張開嘴
擘開兩隻腳	叉開腿
擘開兩隻手指	張開兩個手指
擘爛	撕破
擘唔開	張不開
擘面	翻臉
擘梯	人字梯
擘一字	劈叉
摱	扣
摱	扶
摱	補救
摱車邊	沾光
摱雞	扣扳機
慢下手	很可能
晚黑	晚上
晚晚	每天晚上
晚頭黑	晚上
晚頭夜	晚上
萬大事有我	天塌下來有我頂著
萬大有我	天塌下來有我頂著
萬幾蚊	一萬多塊
萬字夾	回形針
慢住	且慢
慢慢	慢慢地
慢慢講	慢慢說
慢慢行	慢走
慢慢傾	慢慢聊
慢慢食	請慢慢吃
慢手	慢
盲	瞎
盲公	瞎子
盲公竹	導引棒
盲中中	亂碰亂闖
盲佬	瞎子
盲摸摸	瞎摸
盲毛	傻子
盲妹	盲女孩
盲眼	瞎
盲婆	瞎女
猛	兇
猛	威風
猛	旺
猛火	大火
猛咁	極度
猛咁嗌	拼命叫喊
猛咁呻	老抱怨
猛咁食	拼命吃
猛走	拼命跑
猛做	拼命做
猛料	來頭大
猛嘢	大人物
抹	擦
抹窗口	擦玻璃
抹地	擦地板
抹乾淨	擦乾淨
抹乾淨個面	把臉擦乾淨
抹咗一額汗	捏了一把汗
抹面	擦臉
抹身	擦身
抹手	擦手
抹枱	擦桌子
抹枱布	擦桌布
抹一額汗	捏一把汗
貓竇	貓窩
貓公	公貓
貓仔	小貓
貓紙	提示卡
貓招	花招
貓咗	醉了
貓乸	母貓
貓樣	德行
矛	賴皮
矛賴	賴皮
茅山	法術
茅山法術	法術
茅山術	法術
茅山師傅	法師
咪	切割
咪	掐
咪	死背
咪	英里
咪	麥克風
咪家	書呆子
咪高峰	麥克風
咪嘴	假唱
咪書	啃書
咪頭	麥克風
迷迷懵	神志不清
迷頭迷腦	沉迷
咪	別
咪嘈	別吵
米飯班主	衣食父母
咪攪	不幹
咪攪我	不要煩我
咪掛住…	別只想著…
咪去住	先別去
米仔蘭	米蘭花
咪制	甭想
咪走	別跑
咪走呀	不要走啦
咪指擬	甭想
咪住	慢著
咪拘	別客氣
咪拘	甭想
米舖	糧店
米水	淘米水
米通	米香
咪話	別說
咪喐	別動
咪	就…
咪係	不就是
咪就係	不就是
嘜	商標
嘜頭	商標
墨	墨汁
癦	痣
麥皮	燕麥片
墨水筆	鋼筆
癦屎	雀斑
墨硯	硯台
墨魚	烏賊
炆	燉
蚊	元
蚊	蚊子
蚊髀共牛髀	小巫見大巫
蚊髀同牛髀	小巫見大巫
蚊蟲	孑孓
蚊都瞓	太晚
蚊瞓	太晚
蚊雞	塊錢
蚊幾	一塊多錢
蚊幾兩蚊	一元多差不多二元
蚊螆	蚊子
蚊滋噉聲	聲音小
蚊螆咁細	微小
炆豬腳	燉豬蹄
炆豬手	燉豬蹄
蚊零	一塊多一點點
蚊屘	最後
蚊𧕴	蚊咬
抆	擦
文	文章
抆牆	抹牆壁
抆屎	擦屁股
抆桐油灰	泥油灰
文化衫	汗衫
文具舖	文具店
文雀	扒手
文書處理器	文字處理器
問吊	被絞決
問起	問倒
問米	通靈
問米婆	神婆
問心嗰句	說真心話
擝	拔
擝槍	拔槍
擝槍	掏槍
擝出	拔出
擝草	拔草
擝哈	哮喘
擝衡	拉緊
擝爛	扯破
擝貓尾	演雙簧
擝炮	掏槍
擝實	拉緊
擝繩	拔河
擝斷	拉斷
擝鬍鬚	拔鬍子
𤷪	煩
𤷪𤺧	暴躁
𤷪𤷪𤺧𤺧	十分煩躁
盟	不通的
盟鼻	鼻塞
盟籠	密封住
盟晒	鼻塞
盟塞	固執
乜	什麼
乜都	什麼都
乜都得	隨便
乜都假	說啥也不行
乜都唔理	什麼都不管
乜都唔會	什麼都不會
乜都冇	什麼都沒有
乜都冇晒	什麼都沒有了
乜都有	什麼都有
乜東東	啥事兒
乜噉	怎麼會這樣
乜噉嘅	怎麼會這樣
乜咁…	怎麼那麼…
乜咁錯蕩	什麼風把你吹來了？
乜鬼	什麼
乜鬼嘢	什麼東西
乜係你	怎麼會是你
乜滯	不太
乜料	什麼事
乜乜	什麼什麼
乜乜地方	什麼什麼地方
乜乜物物	這個那個
乜水	什麼來頭
乜誰	誰
乜時候	什麼時候
乜事	什麼事
乜說話	哪裡
乜話	哪裡
乜因由	什麼原因
乜人	誰
乜嘢	什麼
乜嘢都冇	什麼也沒有
乜嘢料	什麼事
乜嘢時間	什麼時候
乜嘢話	哪裡
乜嘢話？	什麼？
乜嘢環境？	什麼情況？
乜嘢人	什麼人
襪	襪子
襪褲	褲襪
襪公仔	襪子玩偶
勿歇	不斷
密斟	密談
蜜汁叉燒	甜醬紅燒肉
密質質	密密麻麻
蜜蠟	蜂蠟
密實	嚴實
密絲	小姐
蜜糖	蜂蜜
蜜糖埕	蜜罐
蜜糖豆	青豆
物業	產業
物業代理	地產經紀
物業稅	房產稅
踎	蹲
踎廁	蹲式廁所
踎大牌檔	在路邊的小吃攤檔進食
踎低	蹲下
踎低身	蹲著
踎墩	失業
踎街	露宿街頭
踎監	坐牢
踎坑	上茅廁大便
踎士	鼠標
踎塔	蹲馬桶
某啲	某些
茂	荒謬
茂尼	呆子
咩	什麼
咩	嗎
孭	背
孭重飛	挑大樑
孭帶	背帶
孭得起	扛得起
孭袋	背口袋
咩都唔驚	什麼都不怕
孭飛	承擔責任
孭起	背起
孭債	承擔債務
孭仔	背小孩
孭住藥煲	經常生病吃藥
咩料	什麼事
孭唔起	扛不起
孭上身	背在身上
咩事	什麼事
咩事呀？	什麼事？
咩事啫	怎麼了
孭臊蝦仔	背嬰兒
孭數	承擔債務
孭書包	背書包
咩話？	說什麼？
咩環境？	什麼情況？
咩環境呀？	什麼情況？
孭鑊	背黑鍋
咩嘢	什麼
咩嘢料	什麼事
咩嘢環境呀？	什麼情況？
咩意思	什麼意思
歪	歪斜
歪哩歪斜	歪歪斜斜
歪歪斜斜	歪歪斜斜
歪身歪勢	姿勢不正
屘	末尾
眯	閉
眯埋個嘴	閉著嘴巴
眯埋眼	閉上眼睛
眯埋雙眼	閉著眼睛
溦溦雨	毛毛雨
眯眉眯眼	瞇縫著眼睛
屘二	倒數第二
味	件
微	小
眉豆	白豇豆
眉精眼企	狡猾
微晶片	微芯片
眉鉗	鑷子
微菌	細菌
眉頭眼額	眉眼高低
尾	尾巴
尾班車	末班車
尾車	末班車
尾場	末場電影
尾指	小指
尾樓	渡船
尾龍骨	尾骨
尾數	餘數
味	味道
昧	潛在水下
未	沒
未必	不見得
未曾	還沒
未得	還不行
未得切	來不及
未得住	還不行
未掂	還沒做好
未掂	還沒做好
未瞓醒	沒睡醒
未夠	不夠
未夠班	不夠資格
未夠秤	不夠格
未夠格	沒有資格
未驚過	都不怕
未見到	沒看到
未見過大蛇屙尿	沒見過世面
未見過大蛇屙屎	孤陋寡聞
未知	還不知道
未知死	不懂得利害
昧落水	潛在水底下
未生埋腦筍	幼稚
昧水	潛水
未識死	不懂得利害關係
未有	沒有
未有耐	還早著呢
未完	沒有完成
man	有男子氣概的
名	名字
命仔	小命
命水	命運
命水唔好	命不好
咪錶	儀錶
咪摸	磨蹭
miss	女老師
mean	刻薄
面	面子
面褲	外褲
面頭	上面
棉緊身	緊身棉襖
棉氊	棉毯
棉褸	棉大衣
棉衲	棉襖
棉胎	被套
綿羊	摩托車
綿羊仔	摩托車
免至	免得
面	臉
麵包舖	麵包店
面青	臉色發青
面青青	臉色發青
麵檔	麵店
面都青晒	臉色青青
面口	臉孔
面口差	氣色不好
面口熟	面熟
面紅	臉紅
面紅紅	臉上發紅
面紅面綠	面紅耳赤
面阻阻	兩人爭鬥
面珠	臉蛋
面珠墩	臉蛋
面懵懵	糊塗
面懵心精	裝傻
面凹	酒窩
面皮	臉皮
面皮厚	臉皮厚
面盆	臉盆
麵豉	豆瓣醬
面試	面談
面色	臉色
面色咁差	臉色很差
面色唔好	臉色不好
面善	面熟
明	懂
明火白粥	猛火煮的稀飯
冥鏹	紙錢
明唔明	懂不懂
名牌嘢	名牌貨
明晒	都明白了
搣	撕
搣橙	掰橙子
搣開	撕開
搣爛	撕破
滅火喉	消防水龍
滅火筒	滅火器
廟	寺廟
𠴕	抿嘴
𠴕嘴	抿嘴
𠴕嘴𠴕舌	撇撇嘴
𠴕𠴕嘴	撇一下嘴
瞄	偷看
瞄一眼	偷看一眼
廟祝公	廟祝
妙想天開	異想天開
摩打	馬達
摩度	模特兒
摩羅	印度
摩羅叉	阿三
魔術貼	尼龍搭扣
嚤佗	慢吞吞
摸門釘	吃閉門羹
摸身摸勢	東摸西捏
剝光豬	脫光衣服
剝光衫褲	脫光衣服
剝殼	去殼
剝衫	脫衣服
芒	螢幕
忙到七彩	忙得不可開交
忙到七個一皮	忙得團團轉
忙到死	忙死了
忙到踢晒腳	忙得昏頭轉向
望	看
望都唔望	看也不看
望翻轉頭	回頭看
望住	看著
望佢一眼	瞥他一眼
望生晒	東張西望
望實	看著
望實佢	看著他
望一眼	瞥一眼
唔好	不要
帽	帽子
唔好出聲	不要作聲
唔好嘈	別吵
唔好擔心	別擔心
唔好計帶	不要介意
唔好講	別說
唔好客氣	別客氣
唔好喊	別哭
唔好制	不要答應
唔好啦	不用了
唔好心急	不要焦急
冇水	沒錢
唔好話	別說
冇嘢講	沒話說
唔好預我	不要算我
唔好喐	不要動
無情白事	無緣無故
無端白事	無緣無故
無端端	無緣無故
毛巾褸	毛長外衣
毛管	毛孔
毛管戙	起雞皮疙瘩
毛公仔	洋娃娃
毛氈	毛毯
毛鉗	鑷子
無厘頭	不合理
冇理咁多	不管那麼多
無聊賴	無聊
無無端端	無緣無故
無拏拏	無緣無故
無心裝載	不關心
無他	不為別的
無謂	不必
無謂嘢	沒有意義的事
冇	沒有
冇把炮	沒有把握
冇辦法	沒辦法
冇品	缺德
冇表情	彆扭
冇本心	沒良心
冇出息	沒出息
冇錢使	沒錢花
冇錯	沒錯
冇穿冇爛	無病無災
母帶	原帶
冇大冇細	沒大沒小
冇膽	膽小
冇膽匪類	膽小鬼
冇啖好食	沒有好日子過
冇搭霎	馬虎
冇得…	沒有…的
冇得比	沒法比
冇得坐	沒有位子
冇得頂	好極了
冇得瞓	睡不了覺
冇得揀	別無選擇
冇得講	無話可說
冇得走趲	沒有迴旋的餘地
冇得做	做不成
冇得傾	免談
冇得傾呀	免談！
冇得撈	沒活幹
冇得賣	沒賣的
冇得擝	沒有希望
冇得諗	不值得去想
冇得食	沒有什麼可吃的
冇得彈	極好
冇得睇	沒有看的
冇得玩	沒有指望
冇埞放	沒地兒放
冇埞走	走投無路
冇埞企	無立足之地
冇埞埋手	無處下手
冇埞踎	無容身之地
冇埞匿	沒處躲
冇埞泊車	沒有地方停車
冇埞使	派不上用場
冇啲定性	很淘氣
冇啲挐褦	沒有一點關係
冇定性	淘氣
冇…都唔掂	沒…也不行
冇度數	沒準兒
冇花冇假	真實的
冇法子	沒辦法
冇法啦	沒辦法了
冇符	沒轍
冇家教	沒教養
冇街去	沒有約會
冇解	不像話
冇覺好瞓	睡不著覺
冇計	沒辦法
冇偈傾	談不攏
冇計	不用計較
冇咁多	沒那麼多
冇咁好氣	沒工夫
冇咁易	沒那麼容易
冇咁大個頭唔好戴咁大頂帽	沒那金剛鑽別攬那瓷器活兒
冇緊要	不要緊
冇幾何	不常
冇幾耐	不久
冇記性	健忘
冇句真	沒有一句真話
冇個啱	沒個合適的
冇公德心	缺德
冇關係	沒關系
冇鬼用	沒用
冇下次	下不為例
冇口齒	沒有信用
冇興趣	沒興趣
冇可能	不可能
冇行	沒希望
冇好氣	沒耐心
冇走雞	有把握
冇走趲	時間很緊
冇走趲	有把握
冇再講啦	別再說了
冇做過	沒做過
冇佢修	拿他沒辦法
冇厘	一點也沒有
冇厘搭霎	不講理
冇厘神氣	無精打采
冇厘頭	沒頭沒腦的
冇厘癮	無聊
冇厘癮頭	無聊
冇厘油水	幹活沒有多少錢收入
冇雷公咁遠	遠處
冇料	水平低
冇料到	沒有真本事
冇路走	無路可逃
冇路數	沒有門路
冇…唔掂	沒…不行
冇紋冇路	不講理
冇問題	沒問題
冇乜	沒什麼
冇乜把炮	沒什麼把握
冇乜點	沒什麼特別
冇乜符	沒法子
冇乜可能	不大可能
冇乜好死	不得好死
冇乜好睇	不怎麼好看
冇乜揸拿	沒什麼把握
冇乜滯	沒怎麼
冇乜事	沒什麼事
冇乜成數	希望不大
冇乜人	沒有人
冇乜油水	無利可圖
冇乜嘢	沒什麼
冇乜嘢用	沒什麼用
冇乜意見	沒什麼意見
冇乜用	沒多大用處
冇咩	沒什麼
冇咩嘢	沒什麼
冇咩印象	沒什麼印象
冇尾飛砣	滿天飛
冇面	沒面子
冇挐耕	不相干
冇挐冇褦	毫無關係
冇挐褦	無關
冇你咁好氣	不跟你廢話
冇你修	拿你沒辦法
冇眼界	沒眼力
冇眼界	沒見識
冇眼睇	不管
冇眼睇	不願看
冇銀	沒錢
冇銀喺手	手中沒錢
冇奈何	無可奈何
冇腦	笨
冇譜	離譜
冇晒	沒有了
冇晒表情	失意
冇晒錢	沒錢花了
冇晒符	沒轍
冇晒符弗	毫無辦法
冇晒姣氣	滅了威風
冇晒行	全完了
冇晒心機	垂頭喪氣
冇晒收	一點辦法都沒有
冇晒聲氣	一點希望也沒有了
冇晒聲氣	沒什麼消息
冇晒碎紙	一點兒零錢也沒有
冇散紙續	沒有零票找換
冇心	不故意
冇心機	沒心情
冇心機	無心
冇心肝	沒良心
冇心裝載	不關心
冇修	沒轍
冇收	沒轍
冇手尾	虎頭蛇尾
冇死	不會出錯
冇聲氣	沒希望
冇聲氣	沒消息
冇碎紙續	沒有零票找換
冇相干	不相干
冇相干	不要緊
冇術	沒轍
舞獅	舞獅子
冇時間	沒時間
冇事	沒事
冇事幹	沒事兒
冇食福	沒有口福
冇醒起	忘了
冇所謂	無所謂
冇數講	沒商量
冇數為	划不來
冇睇頭	不好看
冇頭烏蠅	亂碰亂闖
冇拖冇欠	互不相欠
冇話	從不
冇壞	不妨
冇彎轉	無轉圜的餘地
冇王管	沒人管
冇陰功	缺德
冇癮	沒意思
冇人	沒人
冇人幫襯	無人問津
冇人敢聲	沒人敢吭聲
冇人吼	沒人要
冇人吼斗	沒人光顧
冇人冇物	無親無故
冇人錫	沒人疼
冇有怕	不用怕
冇嘢	沒事
冇嘢呀嘛	沒事吧？
冇嘢到	無所收獲
冇嘢做	沒事做
冇耳性	健忘
冇耳聽	不想聽
冇掩雞籠	亂說話的人
冇掩雞籠	隨意出入
冇研究	沒意見
冇腰骨	沒骨氣
冇用	沒用
霧	霧氣
霧水	露水
妹	丫鬟
妹	妞兒
妹釘	小女孩
妹仔	丫鬟
妹仔	女孩
妹仔大過主人婆	反客為主
妹頭	男人婆
妹	妹妹
霉	糟
脢叉燒	烤瘦肉條
梅菜	梅乾菜
霉渧渧	發霉腐爛
煤氣	瓦斯
煤氣喉	煤氣管道
脢柳頭	上肩肉
妹妹仔	小妹妹
脢頭	上肩肉
脢頭肉	上肩肉
媒人婆	媒婆
脢肉	裡脊
木	呆頭呆腦
木	木頭
木獨	愣
木獨佬	呆子
木方	木板
木嚿	木塊
木結他	原聲吉他
木口木面	呆呆的
木糠	鋸末
木嘴	呆子
木木獨獨	傻愣愣
木蝨	臭蟲
木水殼	木瓢
木碎	鋸末
木枱	木桌
牧童笛	豎笛
沐浴露	沐浴乳
門	門
門柄	門把
瞞到	瞞得過
門鉸	門合頁
門口狗	看家狗
門鐘	門鈴
門罅	門縫
瞞唔到	瞞不過
門牙	門齒
門匙	門鑰匙
滿瀉	溢出來
滿天神佛	都鬧翻天了
悶到死	無聊死了
懵	傻
懵閉閉	懵懂
懵丙	傻瓜
懵到上心口	糊塗之極
懵吓懵吓	傻傻的
懵口懵面	發呆
懵仔	傻瓜
懵佬	傻瓜
懵上心口	糊塗之極
懵盛盛	懵然不知
幪	覆蓋
矇	模糊
矇查查	朦朦朧朧
矇查查	糊裡糊塗
幪面	戴面具
幪面人	戴面具的人
挐	同
𤶸	疤
挐挐褦褦	藕斷絲連
挐褦	牽連
乸	母
乸乸地	女氣
乸聲乸氣	女氣
乸型	女氣
嗱	喏
奶奶	婆婆
奶	乳房
乃大鑊	惹禍
奶啡	牛奶咖啡
奶樽	奶瓶
奶昔	牛奶冰淇淋
乃鑊	惹禍
奶油冬甩	奶油甜甜圈
奶油戟	奶油餅
乃嘢	惹禍
𨂾	跨
𨂾過	跨過去
𨂾光黑	天快黑
𨂾日	間隔一天
南便	南邊
男仔	男孩
南無	念經
南無佬	道士
蝻蛇	蟒蛇
男人老狗	大男人的
南乳	紅腐乳
南乳花生	五香花生
南乳肉	五香花生仁兒
揇	用長棍打
腩	腹部的肥肉
赧	疹子
𧕴	疙瘩
難抵	難以忍受
難頂	受不了
難攪	難辦
難做	難為情
難鯁	難吃
難相與	難相處
難食	難吃
難睇	難看
難睇到死	難看得要命
難聽到死	難聽死了
難搵	難找
難飲	不好喝
焫	槍斃
焫	灼
焫親	灼傷
焫到	燙傷
焫雞	烙鐵
焫腳	燙腳
焫著	燙著
焫咗	被槍斃
焫手	燙手
焫傷	灼傷
鬧	罵
鬧爆	臭罵
鬧到七彩	罵得狗血淋頭
鬧交	吵架
鬧人	罵人
鬧熱	熱鬧
泥	土
泥湴	爛泥
泥塵	灰塵
泥牆	土牆
泥擋	擋泥板
泥山	土山
泥氹	泥坑
泥頭車	運泥車
泥肉	土層
諗	想
諗邪	想歪
諗清楚	想清楚
諗清諗楚	琢磨
諗掂	想好
諗掂咗	想通了
諗定	決定
諗多咗	想多了
諗都唔好諗	甭想
諗到	想到
諗翻	想起
諗翻起	終於想起來了
諗翻轉頭	回憶
諗法	想法
諗計	想辦法
諗計仔	想辦法
諗緊嘢	在想事兒
諗極唔明	想來想去就是想不通
諗過	想想看
諗吓	想想
諗起	想起
諗起上嚟	想起來
諗真	想清楚
諗真啲	好好想想
諗住	想
諗橋	想法子
諗落	想一想
諗唔掂	想不通
諗唔到	沒想到
諗唔明	想不通
諗唔通	想不開
諗諗吓	想來想去
諗諗吓	想想
諗深一層	仔細一想
諗縮數	打小算盤
諗頭	想法
諗通	想通
諗嘢	思考
腍	軟
腍啤啤	軟綿綿
腍柿	柿子
腍佛	善良的人
腍善	和善
淰	熟
撚化	捉弄
褦	綁
凹	癟
粒	丁
粒	顆
凹咗	癟了
凹凹凸凸	坑坑窪窪
粒聲都唔出	一句話也不說
粒聲唔出	一聲不吭
𣲷	濕
𥹉	澀
𥹉	磨蹭
𥹉	黏
𥹉黐黐	黏糊糊的
𥹉口	不開胃
𥹉𥹉令	黏黏的
𥹉懦	磨蹭
𥹉懦懦	性格黏糊
𥹉手𥹉腳	慢手慢腳
𥹉油	澀
嬲	氣
嬲爆爆	氣沖沖
嬲到吹鬚睩眼	氣得吹鬍子瞪眼
嬲到震	非常生氣
嬲到死	氣死了
嬲好定笑好	啼笑皆非
嬲死	氣壞了
扭	擰
鈕	鈕釦
扭親	扭傷
扭親隻腳	崴了腳
扭蛋	轉蛋
扭計	刁蠻
扭計	淘氣
扭計大王	調皮鬼
扭計師爺	狗頭軍師
扭計骰	魔方
扭計星	愛撤嬌的孩子
扭計祖宗	調皮鬼
扭紋	淘氣
扭紋柴	淘氣鬼
鈕門	扣眼
扭扭擰擰	扭扭捏捏
扭擰	扭捏
扭實	旋緊
扭屎窟	扭屁股
扭軚	轉舵
扭耳仔	擰耳朵
扭喐	扭動
耨	膩
耨喉	膩
耨市	滯銷
匿	躲
匿去邊度？	躲到哪裡去？
匿埋	藏起來
匿入房	躲到房間裡去了
你un唔un呀？	懂不懂？
你哋	你們
你哋嘅	你們的
你哋自己	你們自己
你哋自己嘅	你們自己的
你點睇	你怎麼看
你份人	你這人
你嘅	你的
你見點	你感覺怎樣
…你個死人頭	…個屁
…你個頭	…個屁
你個人	你的為人
你講咩嘢話？	說什麼？
你講嘢呀？	胡說！
你估	你猜
你好有心	你真好心
你知唔知	你知道嗎？
你自己嘅	你自己的
你做初一，我做十五	以牙還牙，以血還血
你兩個	你們倆
你諗你	你自己拿主意
你諗你，咪諗過隔籬	你考慮你自己的事，別人的事用不著你來費心
你話點就點	你說怎麼辦就怎麼辦吧
囡	疙瘩
女	女兒
女包	女孩
囡囡	女兒
女仔	女孩
女仔之家	女兒家
女仔流流	女兒家
女人型	女性化
五十蚊	五十塊
五花腩	五花肉
五夾板	五合板
五金舖	五金店
五個字	二十五分鍾
五行欠打	欠打
五行欠水	手頭缺錢
五行缺水	手頭缺錢
五張幾	五十多歲
五月節	端午節
啞佬	啞巴
牙	牙齒
牙呀仔	嬰兒
牙擦	狂氣
牙擦擦	自大
牙齒當金使	講信用
芽菜	豆芽
牙骹	牙關
牙斬斬	貧嘴薄舌
牙尖嘴利	尖嘴薄舌
牙箍	牙套
牙罅	牙縫
牙丫	嬰兒
牙丫仔	嬰兒
牙屎	牙垢
牙煙	險
牙肉	牙床
瓦煲	砂鍋
瓦背	屋頂
瓦背頂	屋頂
瓦罉	砂鍋
瓦坑	屋頂
瓦渣	瓦礫
瓦渣崗	瓦礫堆
瓦仔	馬賽克
雅枝竹	洋薊
瓦面	屋頂
瓦通紙	瓦楞紙
瓦通紙盒	瓦楞紙盒
瓦簷口	屋簷
掗	佔
掗埞	佔地方
掗開	張開
掗開對腳	張開兩條腿
掗拃	礙事
掗掗拃拃	礙手礙腳
掗位	佔位置
挨憑	依靠
挨近	靠近
挨晚	傍晚
挨年近晚	快過年了
挨拼	椅子的靠背
挨拼椅	椅子
嗌	喊
嗌大交	大吵一架
嗌街婆	潑婦
嗌交	吵架
嗌救命	喊救命
嗌…做	叫…做
嗌做	叫做
嗌唔喐	叫不動
嗌名	點名
嗌生嗌死	哭喊著要死要活
嗌生晒	吵吵鬧鬧
嗌霎	衝突
嗌通街	愛罵街的人
嗌痛	叫痛
嗌人	喊人
嗌嘢	叫東西吃
嗌嘢食	叫東西吃
捱	熬
捱白飯	過苦日子
捱得	能吃苦
捱得苦	能吃苦
捱番薯	過苦日子
捱苦	吃苦
捱更抵夜	熬夜
捱飢抵冷	捱餓受凍
捱飢抵餓	忍飢捱餓
捱穀種	吃老本
捱齋	吃素
捱咗成晚	熬了個通宵
捱騾仔	當牛做馬
捱唔住	真的熬不住了
捱眼瞓	熬夜
捱生捱死	熬苦
捱世界	熬日子
捱時間	拖延時間
捱肚餓	捱餓
捱通宵	熬通宵
捱壞	累壞
捱一世	熬了一輩子
捱夜	熬夜
捱義氣	為朋友兩肋插刀
崖鷹	老鷹
呃	騙
呃錢	騙錢
呃稱	謊稱
呃秤	騙斤兩
呃鬼	騙人
呃鬼食豆腐	騙人
呃like	騙讚
呃唔到	騙不了
呃唔到人	騙不了人
呃食	騙吃
呃飲呃食	騙吃騙喝
呃人	騙人
鈪	鐲子
啱	對
啱	湊巧
啱到極	一點兒沒錯
啱feel	合得來
啱偈	投合
啱嘴形	合得來
啱著	合穿
啱key	合得來
啱蹺	合適
啱規矩	按規矩
啱路	順路
啱唔啱	對不對
啱牙	談得投機
啱啱	剛
啱啱夠鐘	正好到點
啱啱好	正好
啱啱要	正要
啱晒	全對
啱使	適用
啱心水	合意
啱身	合身
啱食	適合吃
啱先	剛才
啱數	正合適
啱睇	適合看
啱聽	中聽
啱玩	適合玩
啱用	合用
癌	癌症
巖巉	參差不齊
巖巖巉巉	參差不齊
眼鏡舖	眼鏡店
晏	午飯
晏	晚
晏覺	午覺
晏仔	午飯
晏晝	中午
晏晝飯	午飯
眼	眼睛
眼白白	眼睜睜
眼睥睥	眼瞪瞪
眼瞠唔開	眼睛睜不開
眼赤	眼紅
眼淺	眼皮子淺
眼超超	怒目圓睜
眼大睇過龍	看漏
眼定定	眼光直直地看著
眼定定噉望	兩眼發直地看
眼都大埋	目瞪口呆
眼花花	眼睛昏花
眼瞓	睏
眼火爆	氣炸了
眼火標	憤怒
眼火出煙	氣炸了
眼火都爆	氣炸了
眼闊肚窄	眼大肚子小
眼闊頭窄	眼高手低
眼界	眼力
眼甘甘	貪婪地盯著
眼䀹䀹	盯死
眼角高	高傲
眼公仔	瞳人
眼光光	愣
眼䁪䁪	眼睛眨巴眨巴的樣子
眼仔睩睩	眼睛圓圓的
眼仔碌碌	眼睛滴溜地轉
眼矋矋	斜著看人
眼利	眼力好
眼碌碌	怒目圓睜
眼唔見為淨	眼不見為淨
眼眉	眉毛
眼眉毛	眉毛
眼尾	眼角
眼毛	睫毛
眼矇矇	睡眼惺忪
眼濕濕	淚汪汪
眼水	眼力
眼水	眼淚
眼水	眼藥水
眼屎	眼眵
眼坦坦	翻白眼
眼挑針	麥粒腫
眼肚	下眼皮
眼核	眼珠
眼核光光	眼珠發亮
眼簷	上眼皮
眼翕毛	睫毛
眼熱	眼紅
眼冤	看不順眼
罌	瓦罐
硬係	就是
眼淚水	淚水
硬撐	禁得起
硬打硬	硬碰硬
硬頸	固執
硬角角	硬邦邦
硬淨	硬朗
硬晒舦	鬧僵了
押	掖
鴨	男妓
鴨	鴨子
鴨春	鴨蛋
押高褲腳	捲起褲管
押高衫袖	挽起袖子
鴨公	公鴨
押後	延期
押後處理	待以後再處理
鴨仔	小鴨、小鴨子
鴨仔團	旅行團
鴨嘴帽	棒球帽
鴨嘴帽	鴨舌帽
鴨乸	母鴨
鴨乸蹄	平足
押衫袖	捲起抽子
押屎片	掖尿布
餲	臊臭
餲堪堪	臊臊的
壓力煲	壓力鍋
𢯎	搔
𢯎痕	搔癢
𢯎晒頭	傷腦筋
𢯎身𢯎勢	身上癢
𢯎損	抓破
𢯎損咗	抓破了
𢯎頭	撓頭
𢯎頭	難辦
𢯎頭殼	撓頭
拗胡	醜八怪
拗胡婆	醜八怪
拗	折
拗柴	腳崴了
拗心白菜	油菜苔
拗手瓜	扳胳膊
拗斷	折斷
拗腰	向後彎腰
詏	爭辯
詏頸	抬槓
詏撬	衝突
詏氣	鬥氣
殽	變形
淆底	害怕
殽起身嚟	翹了起來
殽框	搞糟了
殽晒框	搞糟了
咬口	拗口
咬口脣	接吻
咬佢唔入	奈何不了他
咬唔入	佔不了便宜
咬唔入	嚼不動
咬實牙關	咬緊牙關
咬一啖	咬一口
咬耳仔	耳語
噅	求
噅求	懇求
噅噅篩篩	求爺爺告奶奶
噅人	求人
矮傍水	壁腳板
矮躉	矮胖
矮凳仔	小板凳
矮凸凸	矮墩墩
矮瓜	茄子
矮仔	矮子
矮仔多計	矮子計謀多
矮細	矮小
翳	陰暗
翳焗	悶
翳氣	心中氣悶
翳滯	胃口不好的感覺
翳熱	悶熱
危危乎	危險
蟻	螞蟻
蟻竇	蟻窩
蟻躝噉	非常慢
蟻民	小老百姓
奄列	煎雞蛋
揞	摀
揞到實	摀得很緊
揞口	摀住嘴巴
揞住	摀著
揞住對耳	摀著耳朵
揞住個傷口	摀住傷口
揞住嘴笑	摀著嘴巴笑
揞住良心	昧著良心
揞唔住	掩蓋不住了
揞脈	診脈
揞密鑼鼓	悄悄地做
揞眼	摀著雙眼
揞眼法	障眼法
揞實	摀緊
暗	哄小孩睡覺
暗啞抵	吃啞巴虧
吟	嘮叨
扲	掏
吟沉	嘮叨
扲袋	掏口袋
扲荷包	掏腰包
扲雀仔竇	掏鳥窩
吟嚟吟去	嘮叨個不停
吟吟沉沉	嘮嘮叨叨
扲散紙	掏零錢
奀	瘦小
奀過鬼	很少
奀仔	瘦小的孩子
奀妹	瘦小的女孩
奀皮	頑皮
奀皮鬼	調皮鬼
奀細	瘦小
奀瘦	瘦弱
銀	錢
銀包	錢包
銀仔	硬幣
䟴	抖
䟴腳	抖腿
䟴高	踮腳
䟴高腳	踮起腳
䟴䟴腳	抖腿
䟴䟴腳	逍遙自在
䟴身䟴勢	不停抖腿
銀仄	支票
銀錢	元
銀雞	警笛
銀行水浸	銀行資金積壓
銀紙	鈔票
銀紙縮水	鈔票貶值
銀碼	價錢
銀幕	螢幕
韌	老
哽	硌
哽腳	硌腳
哽心	心裡揪著
哽心哽肺	硌得難受
哽耳	逆耳
噏	胡說
罨	敷
罨	漚
噏得出就噏	瞎扯
噏得就噏	胡說
罨耷	簡陋
噏啲乜呀	胡說些什麼
罨汁	潮濕而不通風
噏三噏四	說三道四
罨生草藥	敷中草藥
岌	搖晃
岌岌貢	動彈
岌頭	點頭
岌頭岌髻	點頭點腦
扤	壓
扤失	斤斤計較
扤實	壓緊
勾	勾引
勾	歲
鉤	鉤子
勾佬	勾引男人
嘔	吐
嘔白泡	吐白沫
嘔血	吐血
嘔心	噁心
漚	熬
漚豬潲	煮豬食
牛腸	牛肉卷粉
牛記	牛仔褲
牛頸	牛脾氣
牛腳	牛蹄
牛高馬大	人高馬大
牛牯	公牛
牛公	公牛
牛河	牛肉米粉
牛雜	牛雜碎
牛仔	小牛
牛仔布	勞動布
牛仔砵	牛仔靴
牛仔骨	小排骨
牛治	熟牛肉三明治
牛𦟌	牛腱子
牛精	倔
牛噍牡丹	不識好歹
牛欄	牛圈
牛柳	牛裏脊
牛脷	牛舌頭
牛脷酥	馬耳
牛唔飲水唔撳得牛頭低	不能強求
牛乸	母牛
牛奶樽	牛奶瓶
牛腩	牛肚子上的肥肉
牛軛	牛鞅
牛扒	牛排
牛皮膠紙	布膠帶
牛皮癬	乾癬
牛頭角順嫂	無知婦女
牛頭唔搭馬嘴	不相干
牛王	蠻橫
牛王妹	男人婆
牛王頭	惡霸
牛一	生日
牛油	黃油
牛油果	鱷梨
牛肉炒河	牛肉炒沙河粉
牛肉腸粉	牛肉卷粉
牛肉乾	罰單
吽	遲鈍
吽哣	呆
吽仔	傻小子
屙	排洩
屙	腹瀉
屙爛屎	便溏
屙尿	小便
屙屁	放屁
屙屎	大便
屙屎唔出賴地硬	推卸責任
屙屎唔出賴地硬，屙尿唔出賴風猛	推卸責任
屙殊殊	尿尿
屙肚	拉肚子
屙夜尿	撒尿
蛾	飛蛾
鵝春石	鵝卵石
鵝春形	橢圓形
鵝蛋形	橢圓形
我哋	我們
我哋嘅	我們的
我哋自己	我們自己
我哋自己嘅	我們自己的
我哋兩老	我們老倆口
我嘅！	我請客！
我嘅	我的
我個人	我的為人
我自己嘅	我自己的
我話你知	我告訴你
餓親	挨餓
臥底	內應
餓鬼投胎	很餓
餓過飢	餓過了頭
餓死老婆瘟臭屋	沒本事
藹	哄嬰兒
噯氣	打嗝
藹臊蝦仔	哄嬰兒
愛	要
愛錫	疼愛
呆鈍	愚鈍
呆吓呆吓	呆呆的
外便	外面
外出	外邊
外底	外面
外埠	海外城市
外父	岳父
外父咁外	礙手礙腳
外家	娘家
外嫁女	已出嫁的女兒
外江	外省
外江貨	外地貨
外江佬	外地人
外公	外祖父
礙口	口吃
外來妹	從外地來做工的姑娘
外賣	帶走
外母	岳母
外母乸	丈母娘
外皮	表面
外婆	外祖母
外省佬	外地人
外太公	太老爺
外太婆	太姥姥
惡	兇
惡補	拼命補習
惡頂	難相處
惡到飛起	非常兇
惡瞓	睡不安穩
惡攪	難辦
惡狗	兇狗
惡講	難說
惡行	難走
惡亨亨	兇兇的
惡作	難辦
惡做	難辦
惡鯁	難吃
惡撠	棘手的
惡死	兇惡
惡死能登	惡狠狠
惡睇	難看
惡揗揗	兇兇的
惡爺	兇
惡爺	惡少
惡爺頭	惡少
𩓥	抬
樂隊	樂團
𩓥高個頭	抬起頭
𩓥高頭	抬頭
𩓥頭	抬頭
鱷魚頭	橫行霸道的人
安	捏造
安樂	舒服
安樂茶飯	生活安穩
安樂晒	放下心頭大石
安老院	老人院
安士	盎司
安人	婆婆
按	押
案底	前科
按金	押金
昂住瞓	仰睡
戇	傻
戇居	傻瓜
戇居居	儍乎乎
戇佬	傻子
戇戇哋	傻頭傻腦
戇喪	傻
擙	夠
擙落嚟	夠下來
擙唔到	夠不著
𢳆	搖
屋	房子
屋邨	公宅
屋仔	小屋
屋租	房租
屋主	房東
屋主婆	房東太太
屋契	房產證
屋企	家
屋企人	家人
屋苑	住宅小區
壅	埋
壅肥	施肥
壅泥	培土
㧬	推
㧬低	推倒
㧬跌	推倒
㧬冧	推倒
㧬落	推下去
㧬門	推門
㧬人	推人
蕹菜	空心菜
甕缸	大缸
呢	這
呢便	這邊
呢駁	近來
呢次弊	這回糟了
呢單嘢	這件事
呢啲	這些
呢啲嘢	這些東西
呢度	這邊
呢款	這種
呢幾年嚟	這幾年以來
呢個	這個
呢個係	這是
呢個禮拜	這個星期
呢個時候	這時
呢個嘢	這傢伙
呢個月	這個月
呢陣	這時
呢陣時	現今
呢隻嘢	這傢伙
呢種	這種
呢期	近來
呢輪	最近
呢槓嘢	這種事情
呢味嘢	這樣的事情
呢排	最近
呢排好唔掂	這些日子真不順當
呢鋪	這次
呢世	這輩子
呢世人	這輩子
呢處	這邊
呢頭	這邊
呢停	這種
呢停車	這款車
呢停人	這種人
呢條友	這小子
呢位	這位
呢勻	這回
呢一度	這個地方
呢嘢	這個東西
呢樣	這種
搦	提
搦出去	拿出去
搦過嚟	拿過來
搦走	拿走
搦住	提著
搦唔喐	拿不動
念口黃	光背
𢆡	乳房
𢆡罅	乳溝
𢆡頭	乳頭
捻	捏
捻頸	卡脖子
捻乾	擠乾
捻爛	捏破
捻死	掐死
年初一流流	大年初一的
年桔	金柑
年紀細	年紀小
年晚	年根兒
年尾	年底
年尾花紅	年終獎金
年卅晚	除夕
年三十	除夕
年三十晚	除夕夜
年宵嘢	年貨
年頭	年初
年初一	大年初一
拎	拿
拎出	取出
拎出去	拿出去
拎出嚟	拿出來
拎翻去	提回去
拎翻屋企	拿回家
拎住	提著
拎唔出	拿不出來
檸賓	檸檬利賓納
檸茶	檸檬茶
檸七	檸檬七喜
檸樂	檸檬可樂
檸蜜	蜂蜜檸檬
檸水	檸檬水
檸檬撻	檸檬餡兒餅
擰	轉
擰動	搖動
擰個頭過嚟	扭過頭來
擰過身嚟	轉過身來
擰過頭嚟	轉過頭來
擰轉頭	回頭
擰轉	扭
擰轉面	扭轉臉
擰轉身	轉身
擰螺絲	轉螺絲
擰歪面	別過臉去
擰晒頭	搖頭
擰實	旋緊
擰實樽蓋	旋緊瓶蓋
擰實水喉	擰緊水龍頭
擰頭	搖頭
擰頭擰髻	搖頭晃腦
尿兜	小便斗
尿急	憋尿
尿急急	憋不住尿
尿喉	尿管
尿片	尿布
糯米	江米
糯米糍	江米糰子
耐	久
耐不耐	偶爾
內鬼	內奸
耐過頭	太久了
耐中	偶爾
奈佢唔何	真拿他沒辦法
奈唔何	無可奈何
耐唔中	偶爾
耐唔耐	偶爾
耐耐	偶爾
腦筍	囟門
腦筍未生埋	幼稚
燶	焦
燶起塊面	黑著臉
暖	溫暖
暖笠笠	暖暖和和
暖粒粒	暖烘烘的
暖暖哋	暖暖的
暖水壺	熱水瓶
暖壺	暖瓶
嫩	年輕
柯打	命令
柯崙	奧綸
柯佬	口試
愛靚唔愛命	貪圖漂亮的形象而損害健康
安全砵	安全靴
按揭	抵押
O記	有組織罪案及三合會調查科
O嘴	張口結舌
OK	行
OK難	相當困難
O晒嘴	張口結舌
O.T.	超時工作
趴屎	摔倒
趴時	合格
passport	護照
派司	通過
扒	肉排
怕你呀	算你狠
怕醜	害羞
怕醜草	含羞草
怕凍	怕冷
怕擳	怕癢
扒	划
扒錢	刮錢
爬格仔	寫稿
爬起嚟	爬起來
扒龍舟	賽龍船
扒龍船	划龍船
爬上爬落	上山下山
扒頭	超越
扒艇	划船
扒艇仔	划船
派	發
派報紙	送報紙
派籌	發號兒
派彩	分發獎金
派飛	發票
派街坊	送給鄰居親友
派禮餅	派送喜餅
派利是	發紅包
派片	給保護費
派信	投遞信件
派帖	分發請帖
派台歌	主打歌
派台歌曲	主打歌
派糖	送喜糖
派位	分配學額
排	一段時間
牌	執照
排長龍	排大隊
排第屘	排最後一名
排隊排孻屘	排隊排在最末尾
排孻屘	排在最末尾
排頭位	排到最前面的位置
part-time	兼職
拍	並
泊	停放
拍膊頭	關係密切
泊車	停車
泊車場	停車場
泊車咪錶	停車收費碼表
泊車位	停車位
拍低	拍下
泊低	停下
泊低架車	停車
拍檔	伙伴
拍檔	合作
柏金遜症	帕金森病
拍薑噉拍	打人
拍戲	拍片
拍紙簿	便箋
拍住上	合作
拍爛手掌	拍手叫好
拍埋	拼合起來
拍門	敲門
拍硬檔	緊密合作
拍片	拍電影
拍晒烏蠅	生意非常清淡
拍心口	保證
拍手掌	鼓掌
拍手掌歡迎	鼓掌歡迎
拍手無塵	一貧如洗
拍拖	約會
拍烏蠅	生意清淡
拍藥	嗑藥
拍丸	嗑藥
棚	排
棚	腳手架
棚架	腳手架
蟛蜞	小螃蟹
棚寮	竹棚
拍乸	搭檔
派對	聚會
坺	攤
泡	泡
泡打粉	發粉
拋低	扔下
拋浪頭	虛張聲勢
拋生藕	灌米湯
拋骰	擲骰子
拋骰仔	擲骰子
拋書包	賣弄學問
刨	礤床
跑馬	賽馬
炮	槍
豹	豹子
炮製	整
炮仗	鞭炮
炮仗頸	火性子
泡油	過油
刨	死背
㓟	削
批	抹
批	派
批	猜
㓟菠蘿皮	削菠蘿皮
批蕩	抹灰
批灰	抹灰
批中	料到
㓟皮	削皮
批評家	評論家
㓟蘋果	削蘋果
㓟鉛筆	削鉛筆
頻頻撲撲	東奔西跑
頻撲	奔波
憑咩	憑什麼
婄	暄
婄木	泡木頭
啤	撲克牌
啤	雙
披牌	撲克牌
巴仙	百分之一
䠋	歪倒
paper	作文
皮	元
皮	皮革
皮草	毛皮
皮草店	毛皮服裝店
皮蛋	松花蛋
皮蛋酥	以皮蛋做餡的傳統小吃
皮喼	皮箱
皮光肉滑	皮膚嫩滑
皮褸	皮夾克
皮袍	皮襖
貔貅	頑皮
貔貅仔	淘氣孩子
被	被子
被竇	被窩
被冚	被單
被鋪	鋪蓋
劈	喝
劈	砍
僻價	砍價
擗開	扔到一邊去
劈酒	喝酒
擗咗	扔了
擗炮	辭職
擗炮唔撈	辭職不幹
劈友	砍人
擗	扔
拼	靠背
拼沉	把對方打敗
𩩍骨	肋骨
平	便宜
平到飛起	便宜得很
平價	低價
平價市場	廉價市場
平夾靚	既便宜又好
平沽	賤賣
平靚正	又便宜又好
平嘢	便宜貨
平嘢唔靚	便宜沒好貨
pat	屁股
pizza	比薩餅
PC	警員
PTU	警察機動部隊
編碼	編號
揙	揍
片	唱片
片	尿布
片石	打水漂
片石仔	打水漂
片糖	片狀的紅糖
平底鑊	平底鍋
蘋果批	蘋果派
平安紙	遺囑
平頭裝	平頭
漂白水	漂白
嫖友	嫖客
樖	棵
婆乸	婆娘
婆乸型	女氣
破	劈
破柴	劈柴
破財擋災	破財免災
破口大鬧	破口大罵
破開	劈開
破開兩邊	劈開兩邊
婆媽	婆婆媽媽
婆婆	外祖母
卜	泡
撲	奔波
撲飛	到處找票
撲嚟撲去	跑來跑去
撲料	搜集材料
撲心撲命	盡心盡力
撲水	到處籌款
鋪草皮	賭馬輸了錢
甫士	姿勢
甫士咭	明信片
普羅大眾	市民
普洱	普洱茶
舖	店舖
舖仔	小店
舖頭	商店
舖位	攤位
浮	浮
蒲	混
蒲吧	泡酒吧
蒲的士高	去迪斯科消遣行樂
蒲點	娛樂場所
蒲瓜	葫蘆
蒲起	浮起來
蒲開	閒玩
蒲酒吧	泡酒吧
蒲精	玩樂者
蒲面	露面
蒲女仔	泡妞
浮薸	浮萍
葡撻	葡式蛋塔
菩提酒	葡萄酒
菩提子	葡萄
蒲頭	露面
蒲友	玩樂者
泡	泡
抱男孫	抱孫子
pro	職業
蒲飛	自助餐
陪瞓	陪睡
賠唔翻	賠不起
仆	趴
仆親	摔著了
仆低	趴下
仆喺張枱度	趴在桌子上
仆住瞓	趴著睡
仆轉	反轉
拚	拚
拚咗佢	豁出去了
判頭	包工頭
盤口	價格
盤滿缽滿	收穫豐盛
塳	蒙
塳塵	灰塵
塳起	揚起
塳晒塵	蒙上塵
撥	扇
撥大葵扇	做媒人
撥火	煽火
撥爐	煽爐子
撥扇	扇扇子
卅	三十
卅八	三十八
卅七	三十七
卅九	三十九
卅幾蚊	三十來塊錢
卅六	三十六
卅五	三十五
卅三	三十三
卅四	三十四
卅歲人	三十歲
卅一	三十一
卅二	三十二
沙煲	沙鍋
砂煲	沙鍋
砂煲罌罉	鍋碗瓢盆
沙塵	驕傲
沙塵白霍	驕傲自大
沙槌	沙錘
沙池	沙坑
沙蟲	孑孓
沙膽	大膽
沙甸魚	沙丁魚
沙葛	豆薯
沙河粉	米粉條
沙井	人孔
沙井蓋	人孔蓋
沙井口	人孔
沙紙	畢業證書
紗紙	文憑
沙展	警察巡官
沙𩶘	鯛魚
沙律	沙拉
沙龍	攝影作品展覽
沙蟬	蟬
沙蟬殼	蟬蛻
沙田柚	柚子
沙翁	沙翁
耍得	有本事
耍花槍	撒嬌
耍家	擅長
耍樂	娛樂
耍樂	打麻將
耍盲雞	矇眼捉人
沙	沙啞
沙沙滾	草率
嘥	浪費
嘥	看貶
嘥錢	浪費錢
嘥地方	浪費地方
嘥到一錢不值	貶得一錢不值
嘥鬼氣	白費勁兒
嘥氣	白費勁
嘥心機	費神
嘥心機捱眼瞓	白費勁
嘥聲壞氣	白費脣舌
晒士	尺寸
嘥時間	浪費時間
嘥食物	浪費食物
嘥撻	糟蹋
晒	全
曬	曝曬
曬到死	曬得要命
曬冷	攤牌
曬冷	沙蟹
曬馬	顯示實力
曬命	自誇命運好
曬衫	晾衣服
曬相	洗照片
曬嘢	自誇
曬熱頭	曬太陽
衫	衣服
三步擸埋兩步走	三步並作兩步走
衫刷	洗刷衣服的刷子
衫袋	口袋
衫褲	衣服
衫架	衣架
三夾板	三合板
三急	當務之急
三九唔識七	誰也不認識誰
衫腳	下襬
三腳凳	小陷阱
三腳雞	機動三輪車
三個骨	四分之三
三個骨	四十五分鐘
三個字	十五分鐘
三口六面	各方面
三項鐵人	鐵人三項
三仔	三級片
衫袖	袖子
三隻手	小偷
三張幾	三十多歲
三尖八角	形狀不規則
衫裙	連衣裙
衫爛咗	衣服破了
衫裏	裏子
衫裡	衣服裡子
三六	狗肉
三唔識七	互不認識
三蚊雞	三塊錢
三文治	三明治
三文魚	鮭魚
衫鈕	釦子
三鳥	雞鴨鵝
三鳥成群	雞鴨鵝成群旺相
三衰六旺	禍福
三歲定八十	三歲看老
三少	丈夫的三哥
山	島
閂	關
閂窗	關上窗戶
山草藥	草藥
山草藥舖	草藥店
山地車	登山車
閂到實	關好了
閂到實晒	關好了
山墳	墳墓
山仔	小山
山豬	野豬
山豬竇	野豬穴
山卡罅	偏僻的地方
山卡罅	山谷
山卡罅嘅地方	偏僻的地方
山蜞	旱螞蟥
山欖	橄欖
山窿	山洞
閂唔實	關不嚴
閂唔死	關不牢
閂埋度門	關上門
閂埋門	關上門
閂門	關門
山泥傾瀉	山體滑坡
山埃	氫化鉀
閂舖	打烊
閂實	關好了
散	散開
散工	零工
散仔	打雜的
散仔	警察
散紙	零票
散咗	分手了
散咗	散開
散賣	零售
散銀	零錢
散散收收	鬆鬆散散的樣子
散使	零花
散收收	散亂
散手	本領
散春	魚產卵
散檔	散伙
散毒	排毒
散水	逃
散瘀	消腫
孱	弱
潺	黏液
孱仔	孱弱的孩子
生	先生
生	活著
生	長
生暗瘡	長青春痘
生啤	生啤酒
生啤啤	生小孩
生暴	陌生
生暴人	陌生人
生抽	淡醬油
生菜	萵苣
生瘡	長膿包
生草藥	中草藥
生蟲	長蟲
生蟲柺杖	靠不住的人
生蛋	下蛋
生得	長得
生得醜	長得醜
生得幾靚	長得挺漂亮的
生得好睇	長得好看
生得靚	長得漂亮
生得靚仔	長得帥
生花	鮮花
生花柳	染梅毒
生粉	芡粉
生飛螆	長口瘡
生雞	好色
生雞	未閹過的公雞
生雞仔	小公雞
生雞精	色鬼
生鼓脹	腹部鼓脹
生穀牛	長米象
生鬼	詼諧
生骨刺	長骨刺
生骨大頭菜	被寵壞的孩子
生果	水果
生果檔	水果攤子
生果金	老齡津貼
生果欄	水果批發店
生果舖	水果店
生果盤	水果盤
生蝦	活蝦
生蝦噉跳	蹦蹦跳跳
生蠔	生牡蠣
生痄腮	患腮腺炎
生仔	生孩子
生仔育女	生兒育女
生螆	患皮膚病
生螆	長寄生小蟲
生螆狗	癩皮狗
生螆貓	病貓
生螆貓入眼	一見鍾情
生癪	患疳積病
生癪仔	患疳積病的小孩
生招牌	活招牌
生豬	未閹過的公雞
生cancer	患癌
生欖	橄欖
生冷	涼的食物
生瘌痢	長頭癬
生蘿蔔	長凍瘡
生埋腦筍	成熟
生猛	生龍活虎
生猛海鮮	活海鮮
生面口	陌生
生滿	長滿
生滿晒	長滿了
生眼挑針	眼睛長針眼
生勾勾	活生生
生外	見外
生安白造	捏造
生壅	活埋
生晒	不停地
生晒草	長滿了草
生晒鍟	長滿了鏽
生神仙	活神仙
生蝨乸	長蝨子
生鏽	長鏽
生蛇	長帶狀疱疹
生鍟	生鏽
生癬	長癬
生性	懂事
生雪	人造冰
生劏	活活宰殺
生人霸死地	佔著毛坑不拉屎
生人唔生膽	沒有膽量
生人勿近	非常兇狠的樣子
生日咭	生日卡
生日派對	生日聚會
生日會	生日聚會
生油	花生油
生意仔	小生意
生意佬	商人
生鹽	粗鹽
生熱痱	長痱子
生魚	烏鱧
生魚治塘蝨	一物降一物
生肉	長肉
㨘	刷
㨘	砸
㨘	罵
㨘波餅	用球擊別人
省鏡	漂亮
㨘乾淨	刷乾淨
㨘唔甩	刷不掉
㨘牛王	勒索
省城	廣州
省城話	廣州話
㨘黃魚	勒索
sharp	清晰
霎氣	慪氣
霎氣	操心
霎戇	傻瓜
霎時	剎那
霎時間	剎那
烚	煮
烚蛋	煮雞蛋
烚番薯	煮白薯
烚餃	水餃
烚雞蛋	煮雞蛋
烚粽	水煮粽
烚豬潲	煮豬食
烚粟米	煮玉米
烚粟米	煮玉米棒子
烚熟	煮熟
熠熟狗頭	傻笑
煞科	結束
煞掣	剎車
煞唔切掣	來不及剎車
煞尾科	末尾
殺食	有效
筲箕	篩子
潲	豬食
哨牙	齙牙
睄	掃一眼
睄佢一眼	掃他一眼
篩	晃動
西班牙話	西班牙語
西餅	西式點心
西便	西邊
西斜	西曬
西斜熱	西曬
西多	法國土司
西多士	法國土司
西瓜核	西瓜籽
西紙	外幣
西裝骨骨	西裝革履
西裝褸	西裝外套
西芹	芹菜
西蘭花	青花菜
西冷	牛腰肉
西冷牛扒	沙朗牛排
篩嚟篩去	搖來晃去
犀利	厲害
西米	西谷米
西文	外文
西片	外國電影
西生菜	包心萵苣
西水	洪水
西人	西洋人
西柚	葡萄柚
西柚汁	葡萄柚汁
西洋菜	豆瓣葉
使	使喚
使	花
使	要
洗白白	洗操
使錢	花錢
使得	頂用
使筷子	用筷子
使費	費用
使頸	使性子
洗腳唔抹腳	亂揮霍
洗黑錢	洗錢
駛𢃇	駕船
洗唔甩	洗不掉
使唔晒	花不完
使唔使	要不要
使唔使…呀？	必須…嗎？
使媽	佣人
洗米	淘米
洗米水	淘米水
使乜	何必
使乜道歉	不用道歉
使乜噉	何必這樣
使乜咁客氣	不用客氣
使乜驚呀	用不著怕了
使乜講	不用說
洗面	洗臉
洗面手巾	洗臉毛巾
使婆	佣人
使晒	花光
洗衫	洗衣服
洗衫板	搓板
洗衫梘	洗衣粉
洗身	洗澡
洗濕個頭	身不由己
洗濕咗個頭	陷進去了
洗手盆	水槽
洗頭	洗頭髮
洗頭水	洗髮精
使橫手	請打手
使人	派人
洗衣舖	洗衣店
使用	費用
細	小
世伯	伯伯
細髀	小腿
細膽	膽小
細嚿	塊兒小
細個	小
細個嗰陣	小時候
細個嗰陣時	小時候
細個仔	小孩子
細個仔嗰陣	小時候
細過頭	太小了
勢兇夾狼	氣勢洶洶
細仔	小兒子
世姪	年輕人
細隻	小
細佬	弟弟
細佬哥	小孩
細佬哥頭	大小孩兒
細路	小孩
細路哥	小孩
細路仔	小孩
細路仔	男孩
細路女	女孩
細蚊仔	小孩
細妹	妹妹
細粒	地位低
細粒	矮小
細粒	粒兒小
細細個	年紀小小
細細粒	地位低
細細粒	矮小
細細粒	粒兒小
細細聲	小聲
細嬸	內弟媳
細聲	小聲
細聲啲	小聲一點
細時	小時候
世叔	叔叔
細雨	小雨
噬	咬
噬人	咬人
噬一啖	咬一口
誓願	發誓
誓願當食生菜	無信義
誓願當食生菜	起誓當白饒
塞	曾孫
塞車	交通阻塞
塞豆窿	小孩子
塞坑渠	下水道不通
塞晒車	馬路上十分堵車
塞實	堵死
塞實晒	堵死
塞孫	曾孫
森巴	桑巴
森巴舞	桑巴舞
森巴樂	桑巴樂
心情極靚	心情極佳
心情唔靚	心情不佳
深切治療部	重症監護室
心大心細	猶豫
心多多	三心二意
心都寒埋	令人害怕
心都寒晒	令人害怕
心慌慌	慌張
心甘命抵	心甘情願
心急	著急
心機	心情
心機	精神
心肝椗	心肝寶貝
心掛掛	牽掛
心口	胸脯
心口針	胸針
心口痛	胸口疼
心寒	害怕
心好翳	心裡很煩悶
心知肚明	心裡明白
心照	心照不宣
心涼	痛快
心諗	心裡想
心翳	胸悶
心噏	心裡納悶
心抱	新娘
心抱仔	小媳婦
心水	心意
心水清	頭腦清醒
心思思	惦著
心息	死心
心淡	心灰意冷
心頭火起	發火
心頭高	心氣高
心甜	心中痛快
心悒	憂鬱
心喐	心動
心喐喐	動心
糝	撒
糝古月粉	撒胡椒粉
糝芝麻	撒芝麻
滲蚊仔	小孩
甚至乎	甚至
薪酬	工資
身材好弗	身材很標緻
新地	聖代
辛苦命	命苦
辛苦晒	辛苦了
身家	家產
身紀	身孕
新記	香港新華分社
身嬌肉貴	嬌生慣養
身光頸靚	衣著光鮮
身㷫	發燒
新仔	新手
新淨	嶄新
身子	身體
伸直腳	死亡
伸直咗	死亡
新正頭	正月期間
身壯力健	身強力壯
伸懶	伸懶腰
新嚟新豬肉	新人
伸脷	伸舌頭
新郎哥	新郎
新屋入伙	搬進新房子
新年咭	賀年卡
新年流流	大過年的
新年頭	正月期間
新抱茶	娶媳婦
身水身汗	汗流浹背
新屎坑，三日香	貪新鮮
新屎坑，三日新	貪新鮮
新鮮熱辣	新鮮的
新人	新娘
新嘢	新貨
新意思	新意
身型	身材
呻	怨
呻笨	自責
呻吓	發發牢騷
呻氣	埋怨
呻窮	哭窮
神	壞了
神棍	巫師
神憎鬼厭	人人討厭
神咗	壞了
晨早	早晨
晨早流流	一大早的
晨褸	浴袍
神樓	神龕
神神地	不正常
神神化化	古古怪怪的
神神經經	精神不正常
神台貓屎	人人討厭
晨運	晨練
腎	腎臟
濕柴	零票
濕到淰晒	濕透了
濕滯	傷胃
濕滯	難辦
濕吻	舌吻
濕淰淰	濕漉漉
濕𣲷𣲷	濕漉漉
濕晒	濕透了
濕身	沾上麻煩事
濕身	淋濕
濕濕碎	零碎
濕濕碎碎	零零碎碎
濕手巾	濕毛巾
濕水	濕的
濕碎	零碎
濕星	瑣碎
濕星嘢	瑣碎的東西
濕熱	腸胃不適
十點幾	十點多
十分之	非常
十居其九	十之八九
十個字	五十分鍾
十字車	救護車
十足十	十足的
十問九唔應	不喜答話
十五十六	忐忑不安
十扑	支持
十三點	二百五
十畫都未有一撇	八字還沒一撇
十畫未有一撇	八字還沒一撇
十一個字	五十五分鍾
十日	十天
十二碼	點球
失打	快門
失驚忘神	嚇得他臉色都變了
失驚無神	嚇得他臉色都變了
失驚無神	突然
失咗	丟了
失禮	不成敬意
失禮	丟臉
失禮晒	不成敬意
失禮死人	丟人
失禮人	丟臉
蝨乸	蝨子
蝨乸春	蟣子
失晒魂	失魂落魄
膝頭	膝蓋
膝頭哥	膝蓋
膝頭蓋	膝蓋
失魂	慌張
實	一定
實弊	肯定糟糕
實情	實在
實情係	實在是
實情好	實在好
實得	肯定行
實得㗎喇	一定成的
實掂	肯定行
實係	肯定
實行	就是
實行	當然
實枳枳	密密實實
實淨	結實
實Q	保安
實嚟	一定來
實唔係	肯定不是
實牙實齒	一定
實死	完蛋
實死無疑	完蛋
實死冇生	死定了
實食冇黐牙	十拿九穩
實穩	一定
實穩去	一定去
實穩冇錯	一定沒錯
實會	一定會
實要	肯定要
收	藏
收低	收下
收嗲	閉嘴
收爹	閉嘴
收檔	去世了
收檔	收攤
收檔罷啦	收起來吧
收到	知道了
收到風	收到消息
收翻	收回
收費咪錶	停車收費碼表
收科	收場
收風	打聽消息
羞家	羞人
收更	下班
收工	下班
收喺邊度	藏在哪裡
收口	閉嘴
收遮	收傘
修整	修理
修整水喉	修理水龍頭
收租婆	收房租的老太太
修橋整路	修橋補路
收樓	收回房子
收僆	招兵買馬
收爐	過年前最後一天上班
收唔翻	收不回來
收埋	收藏
收買佬	收舊貨的
收買人命	殺人
收屘	後來
收銀處	付款台
收銀台	收款台
收銀員	收款員
收皮	滾開
收舖	關門
收山	洗手不幹
收收埋埋	收藏起來
收手	住手
收聲	住口
修水圳	修理水渠
收線	掛電話
收數	收帳
收數佬	收賬的
收睇	收看
收條	收據
收回佣	收回扣
收油	煞車
手板	手掌
手板眼見工夫	易學易做的工作
手板心	手心
手板堂	手心
手臂	胳膊
手柄	把手
手抽	手提袋
手多多	多手多腳
手袋	手提包
手甲	指甲
手骹	手腕
手巾	毛巾
手巾仔	手絹
手緊	缺錢
手工	手藝
手瓜	胳膊
手瓜起𦟌	胳膊粗壯
手瓜硬	實力雄厚
手骨	後台
手骨	胳膊
手痕	手癢
手踭	手肘
手掣	手閘
手枕	手上的繭子
手震震	手在發抖
手袖	套袖
手指公	大拇指
手指罅	指隙
手指罅疏	揮霍
手指纈	手指節
手指屘	小指
手指模	指印
手指拗出	胳膊肘朝外拐
手指拗出唔拗入	胳膊肘朝外拐
手作	手藝
手作仔	手藝人
手扣	手銬
首期	首付
手鐐	手銬
手襪	手套
手尾	善後
手鈪	手鐲
手勢	廚藝
手信	禮物
手提	手機
手提電腦	筆記本
手揗腳震	手腳發抖
手停口停	一不幹活就沒飯吃了
手拖手	手牽手
瘦到得棚骨	瘦得只有一把骨頭
瘦到飛起	非常瘦
瘦到成條柴噉	瘦瘦的
瘦骨賴柴	骨瘦如柴
瘦骨仙	瘦骨嶙峋的人
瘦骨如柴煲碌竹	骨瘦如柴的人
瘦咗	瘦了
瘦擘擘	瘦瘦的
瘦蜢蜢	瘦瘦的
瘦削	瘦弱
仇口	積怨
壽	傻笨
受得住	受得了
受黑錢	受賄
壽仔	傻瓜
受力	承受重壓
受落	接受
受唔住	受不了
壽癦	壽斑
壽星公	壽星
壽星公吊頸	嫌命長
壽頭	傻瓜
壽頭壽腦	呆頭呆腦
受軟唔受硬	吃軟不吃硬
賒住先	先墊著
些少	一點兒
賒數	賒賬
瀉	灑
寫大字	寫毛筆字
寫低	寫下
寫到明	說明
寫個服字	不由得信服
寫字樓	辦公樓
寫字枱	書桌
寫落嚟	寫下來
寫唔切	來不及寫
卸膊	推卸責任
蛇	躲懶
蛇都死	極遲
蛇都死喇	徹底玩完了
蛇𠺌	膽小
蛇吓先	先躲個懶兒
蛇喱眼	斜眼
蛇頭	偷渡組織者
蛇頭鼠眼	賊頭賊眼
蛇頭鼠腦	賊頭賊眼
蛇王	偷懶
蛇王	懶蟲
社公	社神
死呀	糟了
死畀佢睇	死給他看
死撐	硬撐
死蠢	愚笨
死得眼閉	死而瞑目
死黨	老朋友
死都唔眼閉	死不瞑目
死都話	硬說
死火	熄火
死火	糟糕
死雞撐飯蓋	強辯
死雞撐硬腳	強辯
死咁	很
死咁做	拚命幹
死咁咪	拚命讀書
死跟	死纏
死梗	完蛋
死估估	呆板
死過翻生	死裡逃生
死過佢睇	絕望了
死慳死抵	省吃儉用
死口唔認	死不承認
死氣喉	排氣管
死開	滾
死開啲	滾
死仔	小子
死仔包	死東西
死就死	豁出去
死剩把口	不服輸
死咗火	拋錨了
死咗又翻生	死了又復活
死橋	絕招
死啦	糟糕
死懶鬼	懶蟲
死僆仔	臭小子
死僆妹	壞女孩
死纈	死結
死佬	混蛋
死老鼠	垂頭喪氣的人
死老嘢	老不死
死唔去	死不了
死唔眼閉	死不瞑目
死妹釘	死丫頭
死女包	死丫頭
死牛一便頸	板板六十四
死晒	死光了
死蛇爛鱔	懶人
死蛇爛鱔噉	懶懶散散
死死吓	無精打采
死死吓	要命
死死氣	勉強地
死死氣	垂頭喪氣地
死性不改	本性難移
死人	糟糕
死人兼冧屋	糟透了
死人頭	死鬼
死人嘢	死東西
四十蚊	四十塊
四邊四便	四周
四便	四面
四千蚊度	四千塊左右
四塊半	棺材
四方	方的
四方𡃈	方框
四方木	懶人
四方城	麻將
四方形	正方形
四腳爬爬	趴在地上
四個字	二十分鍾
四季桔	金柑
四號仔	白粉
四仔	色情片
四仔台	成人電視台
四周圍	到處
四正	端正
四張幾	四十多歲
四眼	戴眼鏡的
四眼仔	戴眼鏡的男孩
四眼佬	戴眼鏡的人
四眼妹	戴眼鏡的女孩兒
四平八正	端端正正
四四六六	辦事熟練
四四六六拆掂佢	清清楚楚解決
四圍	到處
四圍撲	到處奔波
錫	吻
錫	疼
錫到燶	溺愛
錫嘴	親嘴
錫紙	鋁箔紙
錫面珠墩	親臉蛋
錫晒	非常疼愛
錫晒你	很疼你
錫身	怕死
錫士	性感
錫壞	慣壞
錫一啖	吻一下
石	石頭
石壆	石欄
石春	鵝卵石
石級	台階
secu	保安
石屎	石屑
sd	送
sense	感覺
聲	聲音
聲喉	嗓子
聲喉坼	嗓子沙啞
聲喉沙	嗓子沙啞
聲氣	希望
聲沙	聲音沙啞
聲線	音色
城	城市
醒翻	醒來
醒瞓	警醒
醒嚟	醒來
鍟	鏽
成	整
成地都係	滿地都是
成家	全家
成嚿佛	一動不動
成個	整個
成個…噉款	整個兒…樣兒
成個…噉嘅款	一副…模樣
成個…噉嘅頭	整個兒…樣兒
成個…噉頭	整個兒…樣兒
成個鐘	整整一個小時
成個禮拜	整個星期
成個買	整個買
成隻病貓噉	可怖的樣子
成朝	整個早上
成朝早	整個早上
成尊佛噉	一動不動
成碌杉	呆板
成碌葛	呆板
成碌木	呆板
成碌薯	呆板
成晚	整夜
成年	整年
成世	一輩子
成世人	一輩子
成身	滿身
成身打冷震	凍得上牙打下牙
成身濕晒	滿身都濕透了
成頭大汗	滿頭大汗
成頭汗	滿頭汗
成日	整天
成日	總是
set	設定
set好	設定好
sales	售貨員
𡄽	滑
𡄽落嚟	滑下來
𡄽滑梯	滑梯
衰	壞
衰	失敗
衰俾人睇	丟人現眼
衰到唔恨	壞透了
衰到唔使恨	壞透了
衰到塌地	壞透了
衰到貼地	倒霉透了
衰到貼地	壞透了
衰格	缺德
衰公	缺德鬼
衰鬼	壞傢伙
衰鬼豆	壞傢伙
衰起上嚟有頭有路	一倒霉就處處倒霉
衰仔	混小子
衰咗	失敗了
衰佬	死鬼
衰女	死丫頭
衰女包	死丫頭
衰婆	壞女人
衰晒	真糟糕
衰神	壞蛋
衰收尾	晚節不保
衰衰地	怎麼著也…
衰衰格格	很缺德
衰衰噉	壞
衰人	壞傢伙
衰嘢	壞事
衰嘢	壞傢伙
衰樣	壞樣兒
水	差
水	錢
水吧	酒水部
水煲	水壺
水撥	雨刷
水廁	抽水馬桶
水蛋	蛋羹
水豆腐	嫩豆腐
水貨	質量差的貨物
水貨	走私貨
水雞	落湯雞
水緊	缺錢
水腳	路費
水瓜	絲瓜
水滾	水開了
水過鴨背	善忘
水鞋	雨靴
水客	走水客
水喉	水管
水喉掣	自來水開關
水喉水	自來水
水喉鐵	鐵管子
水喉通	水管
水殼	水瓢
水掣	自來水開關
水浸	大量資金積壓
水浸	水災
水浸眼眉	火燒眉毛
水圳	水渠
水樽	水瓶
水盡鵝飛	冷冷清清
水螆	水蚤
水靜河飛	冷冷清清
水靜鵝飛	冷冷清清
水摳油	合不來
水蠟燭	香蒲
水尾	剩貨
水尾嘢	剩貨
水皮	水平低
水卜	水泡
水抱	救生圈
水手裝	海軍裝
水蛇春咁長	很長
水氹	水坑
水塘	水庫
水嘢	質量差的東西
水魚	冤大頭
水魚	鼈
水渧渧	水淋淋
碎紙	零票
碎料	小事
歲晚	年終
碎銀	零錢
碎牛	牛絞肉
碎濕濕	零碎
碎吟吟	細碎
碎形	分形
誰不知	誰知
睡房	臥室
睡衫	睡衣
削	軟
削笪笪	軟軟的
削坺坺	稀而爛
徇	申斥
徇一餐	臭罵一頓
筍	好
筍貨	好貨
筍價	好價錢
筍盤	質優價廉的房子
筍嘢	好東西
信肉	信紙
信用咭	信用卡
淳品	淳和
馴品	溫和
純情	純真
脣膏	口紅
順檔	順利
順風車	便車
順風駛𢃇	順水推舟
順風順水	一路順風
順住	沿著
順順攤攤	順順當當
順嫂都知	人人皆知
順攤	順當
相當之	相當
相當之特別	相當特別
相當之好	相當好
傷風	感冒
雙格床	雙層床
雙企人	雙人旁
雙糧	雙薪
雙妹嘜	姊妹花
雙眼簷	雙眼皮
商舖	店舖
相睇	相親
相宜	便宜
相與	相處
相	照片
相底	底片
想…都唔得	想…都不行
相架	鏡框
相機	照相機
想唔…都幾難	不…不行
賞面	賞臉
想嘔	想吐
想話	正想
相士	算命先生
上床瞓	上床睡
上鏡	上電視
上咗路	死
上契	認乾親
上鏈	上發條
上落	上下
上岸	洗手不幹
上岸	發財
上屋企	去家裡
上心	用心
上身	附身
上手	學會
上市	公開發行股票
上市公司	股票公開發行的公司
上堂	上課
上畫	放映
上位	往上爬
上便	上面
上斜	上坡
上個禮拜	上個星期
上下	左右
上下	快要
上晝	上午
上訴得直	勝訴
上頭	上級
上湯	高湯
上勻	上次
cert	證書
裇	襯衫
裇衫	襯衫
術	妙計
屍	屍體
CIB	刑事情報科
CS	客服
絲髮	絲綢
絲髮戲服	綢緞戲服
私家	私人
私家秘書	私人秘書
私家診所	私人診所
私家車	私人汽車
私家貨	私人物品
私家偵探	私人偵探
私家屋	私人房屋
私家醫生	私人醫生
私家醫院	私人醫院
司機	司機
師姑	尼姑
獅子開大口	漫天要價
私鐘妹	應召女郎
絲襪奶茶	港式奶茶
絲帽	螺母
師奶	家庭主婦
斯斯文文	很斯文
思思縮縮	拘束
思縮	拘束
師太	師母
私隱	隱私
私隱權	隱私權
私人屋苑	私人住宅小區
師爺	律師副手
思疑	懷疑
屎	差勁
屎窟	屁股
屎窟窿	屁股眼
屎計	鬼主意
屎急	憋著大便
屎坑	茅坑
屎坑計	壞點子
屎坑橋	壞點子
屎橋	餿主意
屎眼	肛門
屎片	尿布
屎塔	馬桶
屎塔蓋	馬桶蓋子
試鏡	試拍
試過	曾經
試過有一次	曾經有一次
試吓	試試看
試真啲	認真嘗
肆正	漂亮
試味	嚐味
試味道	嚐味
試衫房	更衣室
試身	試穿
四四正正	端端正正
是日例湯	當天賣的湯
時不時	有時
時款	時髦
時款手錶	新款手錶
時間廊	鍾錶店
時候	時間
時候唔夠	時間不夠
時裝騷	時裝秀
匙扣	鑰匙圈
時嘜	時髦
時時	常常
時時都	常常
市道	市面
市道低迷	市場不景氣
市道低迷	經濟不景氣
市況	市面
士巴拿	扳手
士啤	備用
士啤呔	大肚皮
士啤呔	後備車輪
是必	一定
士缽裇	運動衣
事情多羅羅	事情多多的
士擔	郵票
是但	隨便
是但呀	隨便吧
是但你揀	由你決定
是但噏	隨便亂說
士的	手杖
士多	小商店
士多啤梨	草莓
士多啤梨奶昔	草莓牛奶冰淇淋
士多房	堆房
是非多羅羅	是非多多的
事幹	事兒
事關	因為
侍仔	服務員
豉汁	豆豉汁
豉油雞	醬雞
視像	視頻
視像鏡頭	攝像頭
士叻	蟲膠
士碌架	撞球
是是但但	隨隨便便
士撻膽	啟輝器
事頭	老闆
事頭婆	老闆娘
蒔田	插秧
豉油	醬油
豉油碟	醬油碟子
豉油樽	醬油瓶
侍應	服務員
侍應生	服務員
事業線	乳溝
色	色子
識	會
識	認識
識穿	識破
識得	認得
熄燈	關燈
識啲啲扮老師	會一點點就以為自己可以當教師了
識啲唔識啲	一知半解
識到	認識
識do	會做
熄機	關機
識講	會說
識講嘢	口若懸河
飾櫃	櫥窗
息口	利息
色仔	色子
適值	正好
識做	會做
識做	識相
識撈	會掙錢
識路	認識路
識諗	會想
識朋友	交朋友
色水	顏色
熄匙	把引擎關掉
色士風	薩克斯管
識識哋	會一點
識食	會吃
識性	懂事
識少少扮代表	自作聰明
識歎	會享受
識彈唔識唱	只會說不會做
識睇	看得懂
識聽	聽得懂
識聽唔識講	聽得懂不會說
識飲識食	會吃會喝
識人要帶眼	交友要分清好人壞人
識游水	會游泳
息影	停止從影
識認	標記
食	吃
食霸王飯	吃飯不付錢
食白果	輸光
食飽	吃飽
食飽飯等屎屙	不務正業
食飽未	吃飽了嗎？
食波餅	被球擊中
食餐飽	吃個飽
食餐便飯	吃個便飯
食餐勁	吃一頓好的
食餐冇餸飯	吃個便飯
食七咁食	狼吞虎咽
食翅	吃魚翅
食錯藥	吃錯藥
食大茶飯	做偏門生意
食得	能吃
食得瞓得	能吃能睡
食得鹹魚抵得渴	敢做敢當
食得鹹魚就要抵得渴	敢做敢當
食得就食	能吃就吃
食得做得	能吃能幹
食得落	吃得下
食得唔好嘥	別浪費
食檔	小吃攤兒
食到嗒嗒聲	吃得津津有味
食到夠	吃個飽
食翻餐勁嘅	吃大餐
食飯	吃飯
食飯枱	餐桌
食忽得	吸毒
食福	口福
食穀種	吃老本
食過翻尋味	百吃不厭
食過夜粥	有本事
食閒口	吃零食
食口立濕	吃零食
食開	吃慣
食詐糊	搞錯
食詐糊	還沒和牌
食齋	吃素
食雜	吃葷
食滯	吃膩
食滯咗	吃膩了
食剩	吃剩的
食咗	吃了
食咗火藥	惱火
食早餐	吃早餐
食粥	喝粥
食住上	接著上
食落	吃去
食唔飽	吃不飽
食唔切	來不及吃
食唔落	吃不下
食唔安瞓唔落	吃不好睡不著
食唔晒	吃不完
食埋	吃完
食晚飯	吃晚飯
食貓麵	挨罵
食懵咗	傻了
食奶	吃奶
食晏	吃午飯
食晏仔	吃午飯
食牛肉乾	收到罰單
食𢆡	吃奶
食檸檬	被拒絕
食腦	動腦筋
食評家	美食評論家
食晒	吃掉
食生菜	容易
食生菜咁易	易如反掌
食西北風	喝西北風
食塞米	白吃飯
食神	口福
食死貓	背黑鍋
食水	吃水
食水	吞錢
食水	飲用水
食水深	賺錢多
食水太深	要價太高
食肆	餐館
食宵夜	吃夜宵
食消夜	吃夜宵
食…送…	就著吃
食餸尾	吃剩菜
食拖鞋飯	吃軟飯
食枉米	白吃飯
食皇家飯	坐牢
食糊	和牌
食碗面反碗底	吃裡扒外
食人隻車	要人家老命
食夜粥	練武術
食嘢	吃東西
食藥	吃藥
食鹽仲多過你食米	過的橋比你走的路還多
食煙	抽煙
食煙仔	抽煙
食軟飯	吃軟飯
閃電	打閃
閃閃吓	閃著
閃閃炩	閃爍
閃閃縮縮	鬼鬼祟祟
閃縮	鬼祟
仙	分
先	才
先不先	首先
先得	才好
先幾日	前陣子
鮮忌廉	鮮奶油
先嗰駁	前陣子
先嗰輪	前陣子
先嗰排	前陣子
鮮蝦腸粉	鮮蝦卷粉
先至	才
先至唔會	才不會
先晚	前晚
先排	前陣子
先生	丈夫
先生	老師
仙士	分
先時	以前
先頭	鋼材
鮮甜	鮮美
先一排	前陣子
仙遊	去世
仙遊咗	去世了
扇	扇子
𨃩	害
𨃩	滑
線步	針腳
𨃩親	滑倒
𨃩低	滑跌
𨃩跤	摔跤
騸雞	閹雞
𨃩腳	滑腳
𨃩咗一跤	摔了一跤
𨃩咗一腳	滑了一腳
線絡	網兜
𨃩落	滑下
𨃩落去	滑下去
線轆	線軸
線衫	汗衫
𨃩西瓜皮	使人失足
𨃩水	不沾水
𨃩呔	車輪打滑
鱔	鰻魚
善款	捐款
善長仁翁	樂善好施的人
善堂	善會
升	摑
星	明星
星君	胡鬧
星君仔	小胡鬧
升呢	過關
星盆	水槽
星鐵	鋅
繩	繩子
醒	機靈
醒	記起
醒	賞
醒定	注意
醒定啲	當心一點
醒定定	打醒精神
醒起	想起
醒唔起	記不起來
醒目	機靈
醒目啲	機靈點
醒目仔	聰明人
醒你	賞你
醒你嘅	賞你的
醒晒神	精神為之一振
醒神	當心
醒水	警覺
醒獅	舞獅子
醒醒定定	打醒精神
醒少少	當心一點
醒胃	開胃
勝	乾
聖誕咭	聖誕卡
勝嘅	乾杯
勝瓜	絲瓜
勝在	好在
承聞	聽說
承你貴言	託您的福
承諾	承諾
成盤	成交
成數	可能性
乘數表	乘法表
成數低	成功的可能性不大
成數高	成功的可能性大
承惠	感謝
盛行	哪一行
盛惠	感謝
攝	墊
攝青鬼	行蹤飄忽的人
攝高	墊高
攝高枕頭	想清楚
攝高枕頭諗清楚	你把這件事情好好想一想吧
攝灶罅	在娘家吃閒飯
攝錄	拍攝
攝錄機	攝像機
攝唔穩	沒墊平
攝蚊帳	掖蚊帳
攝牙罅	塞牙縫
攝石	磁石
攝鐵	磁鐵
攝入去	塞進去
攝入嚟	塞進來
攝影機	攝像機
蝕	虧
蝕本	虧本
蝕本貨	虧本貨
蝕本生意	虧本生意
蝕本貸	虧本貸款
蝕錢	虧本
蝕底	吃虧
蝕晒大本	虧了大本
燒	烤
燒親	燒傷
燒槍	放槍
燒腸	香腸
消毒火酒	酒精
消防警鐘	火警
消防喉	消防水龍
消防喉轆	消防水龍
燒雞	烤雞
燒咗灰士	保險絲燒了
燒豬	烤豬
燒臘	燒烤
燒臘舖	燒烤店
燒賣	燒麥
燒味	燒烤肉食的總稱
燒鴨	烤鴨
燒鵝	烤鵝
燒鵝髀飯	烤鵝腿飯
燒燶咗	燒焦了
燒炮仗	放鞭炮
瀟湘	秀氣
銷士	推銷員
宵夜	夜宵
消夜	宵夜
燒嘢食	烤燒
燒乳豬	烤小豬
燒肉	烤豬肉
小巴	小型公共汽車
小巴司機	麵包車司機
少不免	難免
小腸氣	疝氣
小豆丁	小鬼
小家	小氣
小家器	小氣
小家種	小氣
少件得件	多一事不如少一事
小器	摳
小學雞	小學生
小珠仔	小珠兒
小心駛得萬年船	小心可保長久平安
小事嚟啫	小事一樁
小息	休息
小食	小吃
小食店	小吃店
少少	一點點
少少咋	一點點而已
少少之嘛	一點點罷了
少少啦	有點兒吧
少少嘢	一點東西
小數怕長計	小數加起來就成大數目
小人蛇	偷渡的少年兒童
少	丈夫的兄弟
少	少爺
笑	笑話
笑餐飽	笑個夠
笑大人個口	笑死人
笑到見牙唔見眼	笑得合不攏嘴
笑到畸畸聲	嘻哈地笑
笑到甩肺	笑掉大牙
笑到碌地	笑得在地上打滾
笑到肚刺	笑疼了肚子
少東	少東家
笑口棗	笑口常開
笑口棗	芝麻棗
笑口吟吟	笑嘻嘻
笑起上嚟	笑起來
笑騎騎	笑哈哈
笑微微	笑嘻嘻
笑笑口	微笑
笑笑口噉講	微笑著說
笑笑口話	笑著說
笑吟吟	笑嘻嘻
紹菜	大白菜
肇菜	大白菜
紹酒	紹興黃酒
梳	梳子
梳打	蘇打
梳打粉	蘇打粉
梳打水	汽水
梳化	沙發
梳化床	沙發床
梳化椅	軟椅
梳芙	享樂
梳乎厘	蛋奶酥
疏肝	暢快
梭哈	沙蟹
梳起	終生不嫁
疏籬	篩子
sorry	對不起
sorry囉	對不起啊
梳孖辮	留雙辮子
梳西裝	留分頭
疏爽	慷慨
疏堂	堂
疏堂兄弟	堂兄弟
疏堂姐妹	堂姐妹
鎖	鎖上
鎖咗	鎖上了
鎖住	鎖著
鎖鏈	鐵鏈
鎖鐐	手銬
鎖門	鎖上門
鎖實	鎖住
鎖實咗	鎖住了
鎖匙	鑰匙
鎖匙扣	鑰匙圈
鎖匙窿	鎖孔
傻更	傻
傻更更	傻乎乎
傻瓜	傻瓜
傻仔	傻瓜
傻仔水	酒
傻豬	傻瓜
傻佬	傻子
傻妹	傻丫頭
傻女	傻丫頭
傻婆	傻瓜
傻傻哋	儍乎乎
傻傻更更	傻頭傻腦
傻人	傻子
腮	腮幫子
嗍	吸
索	繩索
索	迷人
嗍鼻	吸鼻涕
嗍啖煙	吸一口煙
塑膠	塑料
塑膠桶	塑料桶
嗍吓	嗅嗅
嗍氣	喘氣
嗍K	吸毒
塑料	塑膠
索女	美女
嗍晒氣	氣喘吁吁
嗍水	吸水
索油	揩油
嗍嘢	吸毒
嗍煙	吸煙
爽	開心
爽脆	脆
爽口	脆
爽利	興奮
爽手	快
爽手	手感好
爽手啲	快點
喪	傻
喪	散
喪仔	傻子
喪屍	殭屍
short	神經有問題
short哋	神經病
臊	分娩
臊	羶
騷	理睬
騷	秀
鬚	鬍子
臊蝦	嬰兒
臊蝦仔	嬰兒
臊蝦女	女嬰兒
蘇蝦女	嬰兒
蘇州過後冇艇搭	過了這村沒那店
蘇州屎	殘局
騷quali	顯顯本事
鬚刨	刮臉刀
騷擾	打擾
騷擾晒	打擾了
掃	小笤帚
數白欖	數來寶
數臭	臭罵
數唔切	數不清
掃把	掃帚
掃把星	倒霉鬼
掃把星	彗星
數簿	賬簿
掃貨	購物
掃風	拍嗝
數口	價錢
掃埋嚟	掃過來
數尾	尾數
數還數，路還路	人情歸人情，數目要分明
宿	餿
縮	躲
宿包	滿身汗臭味的人
縮膊	端肩
縮得快	閃得快
粟粉	玉米粉
叔公	叔祖
縮骨遮	折疊傘
宿哼哼	餿臭
叔仔	小叔子
縮唔切	來不及躲開
縮埋一嚿	縮作一團
粟米	玉米
粟米粉	玉米粉
粟米羹	玉米湯
粟米片	玉米片
粟米芯	玉米筍
叔婆	叔祖母
縮沙	退縮
縮水	抽
宿宿哋	餿了
熟得滯	太熟了
熟檔	熟悉
熟客	常客
熟客仔	常客
熟口面	面熟
熟口熟面	面熟
熟行	內行
熟落	熟練
熟面口	面熟
熟性	通情達理
熟鹽	精鹽
鬆	溜走
鬆啖氣	鬆了口氣
…鬆啲	…多一點兒
鬆啲	多一點
鬆化	酥脆
鬆骨	按摩
鬆骨	揍
鬆毛鬆翼	沾沾自喜
鬆匹匹	鬆鬆垮垮的
鬆婄	鬆軟
鬆身	寬鬆
鬆人	溜
慫	慫慂
餸	菜
送畀	送給
餸菜	菜
餸飯	菜飯
餸籃	菜籃
餸尾	剩菜
餸頭餸尾	剩菜
輸波	球隊輸了比賽
書檔	書攤
輸賭	打賭
輸到七個一皮	輸得精光
輸到褲穿窿	輸得精光
輸到揸兜	輸得精光
輸到塌地	輸得精光
輸到貼地	輸得精光
輸梗	輸定了
書局	書店
輸晒	輸光
輸蝕	吃虧
輸蝕	差
舒舒服服	很舒服
書枱	書桌
書友	同學
薯	馬鈴薯
鼠	偷
鼠	溜
鼠翻	溜回
鼠翻去	溜回去
鼠翻嚟	溜回來
暑假流流長	暑假過得很漫長
鼠摸	小偷
鼠嘢	偷竊
處	地方
薯	笨
薯仔	馬鈴薯
薯嘜	蠢笨
薯片	馬鈴薯片
薯頭	笨蛋
薯頭嘜	笨蛋
薯頭薯腦	笨頭笨腦
薯蓉	土豆泥
樹大有枯枝	林子大了什麼鳥都有
樹大有枯枝，族大有乞兒	林子大了什么鳥都有
樹熊	無尾熊
樹窿	樹洞
樹頭	樹根
孫	孫子
酸夾宿	指食物已經變壞
孫仔	孫子
酸枝	紅木
酸枝床	紅木床
酸枝傢俬	紅木家具
酸枝枱	紅木桌子
酸枝枱椅	紅木傢具
酸枝椅	紅木椅子
酸微微	酸溜溜
酸梅	梅子
酸宿	汗臭
酸宿爛臭	難聞的酸臭味
酸宿餲臭	難聞的臭味
酸宿宿	形容汗臭
酸酸哋	酸酸的
孫孫塞塞	子孫
酸酸餿餿	酸臭
損	破
損咗	破了皮
損手	生意虧了本
損手爛腳	手腳損傷
損手爛腳	生意不順利
損友	壞朋友
算罷啦	算了吧
算鬼數	算了啦！
算你夠運	算你走運
算死草	鐵公雞
算數	算了
算數喇	算了吧
蒜蓉	蒜末
船飛	船票
船澳	船塢
船頭尺	到處借錢的人
雪	冰
雪藏	冰鎮
雪藏	打入冷宮
雪藏啤酒	冰鎮啤酒
雪藏汽水	冰鎮汽水
雪藏西瓜	冰鎮西瓜
雪藏肉	凍肉
雪糕	冰淇淋
雪糕車	冰淇淋車
雪糕廠	冰淇淋工廠
雪糕批	冰磚
雪糕筒	甜筒
雪糕筒	路錐
雪櫃	冰箱
雪珠	雹
雪豬	凍豬肉
雪屐	冰鞋
雪褸	毛皮大衣
雪梨	鴨梨
雪帽	風帽
雪批	冰磚
雪水	冰水
雪條	冰棍
說話	話
雪油	潤滑脂
雪耳	銀耳
雪耳糖水	銀耳甜湯
雪肉	凍肉
他他條條	舒服
他條	悠然
他條	穩重
呔	輪胎
𧘹	領帶
title	名銜
太凍	太冷
太公	曾祖父
太公分豬肉	人人有份
太公婆	祖先
太過	太
太空褸	羽絨服
太空梭	航天飛機
太子女	千金小姐
太子爺	大少爺
太嫲	太婆
泰文	泰語
太冇解喇	太不像話了
太平門	緊急出口
太平鋪	通鋪
太婆	曾祖母
太爺	曾祖父
太夜	太晚
太陽落山	日落
舦	舵
軚	方向盤
軚盤	方向盤
貪	圖
貪得意	好奇
貪方便	圖方便
貪口爽	圖嘴快
貪著數	貪便宜
貪自在	貪舒服
貪近	繞近路
貪靚	愛美
貪平	貪便宜
貪食	貪吃
貪威	好出風頭
貪威識食	講享受
貪一時方便	圖方便
探	看（朋友）
探班	探望
探盤	摸底
探熱	量體溫
探熱針	體溫計
探員	警員
燂	烤
淡茂茂	淡淡的
淡奶	淡奶
攤	躺
癱	癱瘓
攤大手	伸手
攤大手板	伸手
攤檔	攤兒
攤凍	放涼
攤屍	挺屍
歎	享受
歎報紙	舒服自在地看報紙
歎茶	品茶
歎餐飽	休息了很長的時間
歎咖啡	享用咖啡
碳紙	複寫紙
歎冷氣	享受空調
歎世界	享福
歎元寶蠟燭	死
彈	批評
彈結他	彈吉他
塔	鎖
塔	鎖
塔	馬桶
塌地	非常
塔埋	鎖上
塔埋支筆	把筆套上
塔實	鎖上
塔實度門	把門鎖上
撻	塔
撻	發動
撻	騙
撻車	點火
撻錢	騙錢
撻翻嚟	偷回來
撻著	搭上
撻著	發動了
撻嘢	偷東西
撻定	犧牲預付的訂金
撻住對鞋	趿拉著鞋
撻脷	伸舌頭
鰨沙	比目魚
撻沙魚	比目魚
鰨沙魚	比目魚
撻數	賴賬
撻頭	光頭
梯	梯子
銻	鋁
銻煲	鋁鍋
梯仔	梯子
銻盆	鋁盆
睇	看
睇霸王戲	看戲不買票
睇白	斷定
睇辦	看樣品
睇飽眼	看得入迷
睇病	找醫生治病
睇波	看球賽
睇報紙	看報紙
睇差眼	看走眼
睇診	看診
睇清楚	看清楚
睇錯	看錯
睇穿	看穿
睇大戲	看粵劇
睇低	看不起
睇得出	看得出
睇得化	想得開
睇得過	值得看
睇得起	看得起
睇得明	看得懂
睇電視	看電視
睇定	看準
睇定啲	看準點兒
睇檔	看店
睇都唔睇	看也不看一眼
睇到	看到
睇化	看透
睇法	看法
睇風水	看風水
睇更	守夜
睇見	看見
睇個樣	看樣子
睇高	看得起
睇過點	看情況吧
睇過先	看看再說
睇吓	看一下
睇吓點	看看怎麼樣
睇吓咧	看一看吧
睇吓先	先看一下
睇起	看得起
睇起嚟	看起來
睇起上嚟	看起來
睇戲	看電影
睇開	看開
睇開啲	看開一點
睇好	看好
睇真	看清楚
睇真啲	看清楚點兒
睇準	瞄準
睇症	治
睇鐘數	看時間
睇中	看中
睇重	看重
睇住	看著
睇住佢頭	向他學
睇住嚟	等著瞧
睇佢唔起	看不起他
睇漏眼	看走眼
睇嚟	看來
睇嚟湊	看著辦
睇料	閱讀資料
睇落	看來
睇落去	看來
睇老婆	相親
睇唔出	看不出
睇唔出嚟	看不出來
睇唔清	看不清楚
睇唔切	來不及看
睇唔到	看不到
睇唔見	看不見
睇唔過眼	看不慣
睇…唔起	看不起…
睇唔起	看不起
睇唔開	想不開
睇唔真	看不清楚
睇唔明	看不懂
睇唔順眼	看不順眼
睇唔入眼	看不過眼
睇脈	看病
睇面色	看臉色
睇你唔起	看不起你
睇你唔順眼	看你不順眼
睇啱	看中
睇牛	看牛
睇我唔起	看不起我
睇怕	恐怕
睇破	看透
睇舖	看店
睇衫	買衣服
睇山	看風水
睇實	緊盯著
睇手掌	看手相
睇死	看透
睇衰	蔑視
睇水	把風
睇水色	看形勢
睇相	看照片
睇相	相面
睇相佬	相士
睇上眼	看上
睇星	觀星
睇小	小看
睇數	結帳
睇餸食飯	量入為出
睇書	看書
睇淡	看淡
睇淡晒	看透一切了
睇頭	看頭
睇頭	隨大流
睇頭睇尾	看家
睇勻	看遍
睇勻晒	瀏覽一遍
睇人口面	看人臉色
睇夜	守夜
睇樣	看樣子
睇醫生	看病
體育衫	運動衣
替更	替工
剃面	刮臉
剃眼眉	出醜
剃鬚	刮鬍子
提翻	重提
提子	葡萄
提子乾	葡萄乾
提堂	提審
𧨾	哄
𧨾佢開心	哄他開心
𧨾細蚊仔	哄小孩
𧨾人	哄人
𧨾人爆料	哄人說出真相
𧨾人歡喜	哄人高興
𧨾人入局	哄人上當
氹氹轉	團團轉
氹	坑
吞槍	飲彈
吞錯喉	嗆著
吞咗火藥	吃火藥了
吞唔落	嚥不下
吞樸	偷懶
褪	退
褪步	退步
褪車	倒車
褪幾步	退後幾步
褪過去	挪過去
褪後	退後
褪後啲	退後一點
褪舦	退縮
褪軚	退縮
揗	發抖
揗雞	慌張
揗嚟揗去	轉來轉去
揗晒雞	慌張
揗揗震	顫抖
藤喼	藤箱
藤喼耳	藤箱提手
藤條	藤鞭
藤條炆豬肉	抽打
偷嗒	偷情
偷雞	偷懶
偷龍轉鳳	偷梁換柱
偷呃拐騙	偷盜拐騙
偷師	偷學
偷食	偷吃
偷食	偷情
偷食唔抹嘴	偷吃不懂擦嘴
偷食唔識抹嘴	偷吃不懂擦嘴
偷食唔會撟嘴	偷吃不懂擦嘴
偷睇	偷看
偷影	偷拍
唞	休息
頭	主管
透大氣	深呼吸
唞啖氣	歇口氣
透啖氣	吸一口氣
唞工	工休
唞吓	休息一下
唞氣	歇氣
透氣	呼吸
透氣都唔順	氣都喘不過來
唞足精神	養足精神
唞涼	乘涼
透唔到氣	喘不過氣
唞身	休息
唞順氣	喘一口氣一會兒再幹
唞順條氣	喘一口氣一會兒再幹
唞暑	歇伏
透火	生火
透火煮飯	生火做飯
透過	通過
透爐	生火
透心涼	寒心
頭車	首班車
頭赤	頭痛
頭大	麻煩
頭啖湯	甜頭
頭耷耷眼濕濕	垂頭喪氣沒精打採
頭髮腳	髮邊
頭揈揈	搖頭晃腦
頭夾	髮夾
頭痕	頭疼
頭殼	腦袋
頭簪	簪子
投球	籃網球
頭箍	髮卡
頭盔	安全帽
頭蠟	髮蠟
頭尾	前後
頭泥	頭垢
頭𩓥𩓥	昂起頭
頭擰擰	不停地搖頭
頭皮	頭皮屑
頭皮碎	頭皮屑
頭盤	前菜
頭先	剛剛
頭頭	開頭
頭頭	到處
頭頭碰著黑	到處碰上倒霉事
投懷送抱	主動親近
頭威頭勢	初次
頭位	最前面的位置
頭暈身㷫	不舒服
頭暈身熱	不舒服
剔士	品味
踢爆	揭穿
踢波	踢球
踢腳	陷入窘境
踢館	尋釁
踢晒腳	陷入困境
踢拖	穿拖鞋
踢燕	踢毽子
廳	客廳
聽八音	聽民間音樂
聽得到	聽得見
聽得明	聽得懂
聽笛	聽指揮
聽電話	接電話
聽教	聽話
聽歌	聽音樂
聽講	聽說
聽講話	聽說
聽古唔駁古	聽故事不亂插嘴
講古咪駁古	講故事別插嘴
聽過隔籬	聽錯
廳長	在客廳裡過夜的人
聽住嚟	聽好啦
聽落	聽起來
聽落嚟	聽起來
聽唔到	聽不見
聽唔明	聽不懂
聽唔入耳	聽不進去
聽聞	聽說
聽聞講	聽說
聽晒笛	很聽話
聽實	注意聽好了
聽書	上課
艇仔	中間人
艇仔	小船
艇仔	走之底
推低	推下
推推㧬㧬	推推搡搡
腿治	火腿三明治
退㷫	退燒
T走	奶茶不加糖
T裇	體恤
tissue	面紙
剔	勾
剔手邊	提手旁兒
添	也
添飯	盛飯
甜得滯	太甜了
甜過頭	太甜了
甜甜哋	甜甜的
甜椰椰	甜絲絲的
天秤	起重機
天跌落嚟當被冚	天塌下來有高個子頂著
天花	天花板
天花龍鳳	天花亂墜
天光	天亮
天口	天氣
天口凍	天氣冷
天口㷫	天氣熱
天口熱	天氣熱
天開眼	蒼天有眼
天井	露天空地
天橋	高架路
天棚	曬台
天收	天殺
天收佢	天殺的
天時	天氣
天時凍	天氣冷
天時旱	天旱
天時冷	冷的時候
天時唔好	天氣不好
天時暑熱	天氣炎熱
天時熱	熱的時候
田雞	青蛙
田螺	螺螄
田螺車	混凝土攪拌車
填命	賠命
填鴨	烤鴨
聽暇	待會兒
聽朝	明早
聽朝早	明早
聽早	明早
聽晚	明晚
聽尼士	網球
聽日	明天
聽日再見	明天見
停	樣
聽	等著
聽鬧	等著捱罵
聽捱打	等著捱打
聽死	等著死
聽衰	等著倒霉
聽殃	等著倒楣
停低	停下
停低腳	停下來
停定	停好
停口	住嘴
停落嚟	停下來
停手	住手
貼士	小費
貼士	提示
貼地	現實
貼紙相	大頭貼
貼堂	貼在告示板作示范
鐵筆	撬槓
跌打	中醫骨傷科
跌打酒	藥酒
跌打酒	藥酒
跌打師傅	鐵打師傅
跌打醫生	中醫
鐵閘	鐵門
鐵嘴雞	嘴硬的人
鐵枝	鐵條
鐵騎士	摩托車手
鐵蓮花	指節銅環
鐵馬	摩托車
鐵線	鐵絲
鋼通	鋼管
鐵通	鐵管
挑機	挑戰
跳的達舞	跳踢踏舞
跳飛機	跳房子
跳起身	跳起來
跳扎扎	活潑
跳落	跳下
跳落去	跳下去
跳落嚟	跳下來
跳皮	淘氣
跳蝨	跳蚤
跳蝨市場	跳蚤市場
跳跳扎	活潑
跳入	跳進
條氣唔順	吞不下那口氣
條氣順晒	心情很舒暢
條命凍過水	小命不保
條人龍	隊排得很長
拖	牽
拖板	接線板
拖低	拖下
拖地	擦地板
拖艔	渡船
拖落水	牽累
拖手	牽手
拖手仔	牽手
拖手仔	談戀愛
拖蘇	接線板
拖友	戀人
佗	懷孕
佗	懷
佗啤	懷孕
佗錶	懷錶
砣錶	懷錶
佗槍	持槍
陀地	地痞
陀地費	保護費
佗仔	懷孕
佗住	背著
佗住啤啤	懷孕
佗住細路	背著孩子
佗累	拖累
佗累街坊	連累親戚朋友
佗累晒	拖累別人
佗炮	持槍
佗手褦腳	牽牽扯扯的
佗衰	拖累
佗衰家	害人精
佗衰人	牽累了別人
佗鐵	持槍
佗佗擰	團團轉
佗人	懷孕
妥	妥當
枱	桌子
枱波	桌球
枱腳	桌腿
枱薦	墊布
枱枱凳凳	桌椅板凳
枱椅	桌椅
枱布	桌布
抬轎	捧場
talk	說話
托	吹捧
托	扛
托	用手掌承著
托槍	扛槍
托大腳	吹捧
托下扒	手托下巴
托起	撐起
托賴	托褔
托老闆	拍老闆馬屁
託夢	報夢
托手踭	掣肘
托水龍	代人付款不把錢付出
托上托	轉託
托市	人為支撐股價
劏	宰
劏白鶴	嘔吐
劏車	把汽車拆成零件
湯粉	粉條湯
劏房	分間樓宇單位
劏雞	殺雞
劏光豬	比喻下棋時棋子全被對方吃光
劏開	切開
湯殼	湯勺
劏豬	宰豬
劏豬噉嗌	呱呱大叫
劏西瓜	切開西瓜
劏死牛	打劫
湯水	湯
劏魚	剖魚
湯丸	湯圓
糖	糖果
燙	熨
趟	橫著拉
燙斗	熨斗
燙燶	熨焦
燙衫	熨衣服
唐	中國
堂	十里
堂	架
堂亞哥	堂哥
唐餅	中式糕點
塘壆	基堤
唐餐	中餐
唐餐樓	中餐館
糖炒風栗	糖炒栗子
糖黐豆	形影不離
糖醋脢肉	醋溜裡脊
糖冬瓜	糖醃冬瓜條
堂家姐	堂姐
塘基	池塘埂
唐字	漢字
唐裝	中裝
唐裝衫	中式衣服
唐樓	中式樓房
塘尾	蜻蜓
塘鵝	鵜鶘
唐山	中國
唐生菜	萵苣
堂細佬	堂弟
堂細妹	堂妹
塘蝨	鯰
塘蝨魚	鯰
糖水	甜食
糖水舖	甜食店
堂食	在店內吃
唐人	華人
桃	桃
土共	香港左派
土佬	土包子
土魷	魷魚乾
兔	兔子
淘古井	娶有錢的寡婦
圖章	橡皮圖章
圖則	藍圖
肚	肚子
肚煲	肚子
肚赤	肚子痛
肚臍泵	肚臍
肚臍煲	肚臍
肚䏙	肚子
肚腩	肚皮
肚腍	腸胃不適
肚屙	拉肚子
肚餓	餓
肚痛	肚子痛
通	整
通	管子
通菜	空心菜
通頂	通宵
通掂	通順
通街	滿街
通坑渠	疏通溝渠
通氣	識趣
通知唔切	來不及通知
通渠	疏通溝渠
通渠佬	修理渠道的
通渠師傅	疏通溝渠的師傅
通拉	平均
通窿	通的
通屋	全家
通晒天	事情搞大了
通殺	不放過
通心	空心的
通心菜	蕹菜
通水	串通
通勝	通書
通處	到處
通透	通徹
通天	事情搞大了
桶篤	桶底
痛	疼
痛到死	痛死了
痛到死死吓	痛得要命
痛腳	把柄
痛錫	疼愛
同	跟
同煲同撈	一起混
同…單聲	跟…說一聲
同房	同屋
童軍	童子軍
銅喉	銅管
同學仔	小同學們
同…斟吓	跟…談談
同…撞樣	跟…撞臉
同佢搏過	跟他拼了
同撈同煲	一起混
同埋	而且
同屋	同住一所房子的鄰居
同屋共主	在同一個大院裡住
同屋主	同住一所房子的鄰居
同聲同氣	意見一致
桐油灰	油灰
同…有嘢	跟…有染
團年	吃年夜飯
團年飯	年夜飯
斷正	被揭發
斷尾	根治
斷市	脫銷
脫	套
划	划
嘩鬼	小鬼
蛙式	蛙泳
划艇	划船
娃娃菜	大白菜
蛙人	潛水員
搲	抓
搲花	抓破
搲痕	抓癢
搲爛	抓破
搲毛	抓毛絨
搲損	抓破
嘩	哇
華埠	唐人街
話	說
話畀…知	告訴…
話畀你知	告訴你
話畀你聽	告訴你
話畀…聽	告訴…
話低	交代
話得埋	可以預料的
話定	說定
話都冇咁快	說時遲那時快
話到明	說得明白
話咁快	很快
話咁易	十分容易
話過你知	告訴你
話口	話頭
話口未完	話音未落
話齋	正如…所說
話就咁話	說是這麼說
話就話	說是說
話…知	告訴…
話之	不管
話之佢	管他
話之你	管你
話中	說中
話落	交代
話唔定	說不定
話唔埋	很難說
話名	名義上
話明	說明白
話你知	告訴你
話晒	到底
話聲	說一下
話時話	對了
話事	作主
話事偈	正如…所說
話事啤	沙蟹
話事人	頭兒
話頭唔醒尾	遲鈍
話頭醒尾	舉一反三
淮山	山藥
壞咗	壞了
畫	筆畫
劃花	刮破
畫公仔唔使畫出腸	不必說出來
畫公仔畫出腸	說得太白
或者	也許
畫則	畫圖
畫則師	建築師
灣	停泊
彎低	彎下
灣泊	泊船
挽	提
玩餐飽	玩個夠
玩大	弄大
玩大咗	玩過火了
玩吓啫	鬧著玩玩
挽鞋	提鞋
玩馬騮	耍猴子
玩啤牌	打撲克牌
挽手	提梁
挽手袋	挎手提包
玩死	害苦
挽水	提水
玩人	耍人
玩嘢	耍花招
玩完	完了
玩完	死去
還咗心願	圓了心願
還心願	圓心願
環頭	管區
鯇魚	草魚
橫掂	反正
橫掂係噉	反正都這樣了
橫風橫雨	大風雨
橫街	小街
橫街窄巷	小街小巷
橫街冷巷	小街小巷
橫脷	豬胰
橫丫腸	闌尾
橫丫腸	鬼點子
橫手	不光彩的手段
橫水艔	渡船
橫睇掂睇	橫看豎看
橫又係死，掂又係死	橫豎要死的，怎樣也是死，橫豎都是死，反正都是死，橫豎也是死
橫又死，掂又死	橫豎要死的，怎樣也是死，橫豎都是死，反正都是死，橫豎也是死
滑低	滑倒
滑咗雞	走了火
滑溜	光滑
滑落	連續下跌
滑浪	衝浪
滑浪板	衝浪板
滑浪風帆	風浪板
滑捋捋	滑溜溜
滑牙	擰不緊
滑潺潺	滑滑的
滑鼠	鼠標
滑雪	溜冰
滑雪砵	滑雪靴
滑雪屐	滑冰
滑揗揗	滑溜溜
滑脫脫	光滑
威	威風
威化餅	維夫餅乾
威水	神氣
威也	鋼絲
威吔	鋼絲
位	位子
喂	喂
畏高	懼高
畏高症	懼高症
唯	只
為得過	划得來
惟獨是	只是
為…講好說話	替…說好話
違例泊車	違規停車
為乜事幹	為什麼事情
為…諗	為…著想
維他命	維生素
維他命M	錢
為威喂	誰也不欠誰
唯有	只好
為咗	為了
為乜	為什麼
為食	饞
為食鬼	饞鬼
為食仔	嘴饞的小孩
為食貓	饞鬼
為食友	饞鬼
搵得翻	找回來
溫功課	複習功課
溫書	複習
搵	找
搵笨	騙人
搵邊個	找誰
搵餐飯食	找飯碗
搵餐晏仔食	找飯碗
搵出	找出
搵出嚟	找出來
搵錢	掙錢
搵丁	騙人
搵刀切	用刀切
搵到	找到
搵翻	找回
搵飯食	謀生
搵房	找房間
搵機會	找機會
搵工	找工作
搵工跳槽	求職改行
搵鬼	鬼才…
搵鬼幫襯	沒人買
搵鬼幫手	沒人幫忙
搵鬼買	沒人買
搵鬼信	鬼才相信
搵鬼要	沒人要
搵鬼要咩	沒人要
穩陣	穩重
搵周公	睡覺
搵著數	找便宜
搵嚟攪嘅	自找麻煩
搵嚟辛苦	自找辛苦
搵兩餐	勉強餬口
搵兩餐	找飯碗
搵兩餐晏仔	找飯碗
搵老襯	騙人
搵唔到	找不到
搵唔翻	找不回
搵乜嘢	找什麼
搵銀	掙錢
搵我出氣	拿我出氣
搵我做醜人	要我當挨罵的
搵山草藥	找草藥
搵世界	找生活
搵水洗	用水洗
搵食	謀生
搵繩綁	用繩子綁
搵位	找位子
搵位坐	找位置坐
穩穩陣陣	安安穩穩
搵勻	找遍
搵人	找人
搵人笨	騙人
搵人幫手	找人幫忙
搵人出氣	拿人出氣
搵人老襯	騙人
搵日	改天
搵嘢做	找工作
搵鹽醃	用鹽醃
韞	圈
韞	關
韞黑房	關禁閉
韞𨋢	被困在電梯裡面
韞入黑房	關禁閉
勻	遍
暈車浪	暈車
勻巡	均勻
暈低	暈倒
暈機浪	暈飛機
魂精	太陽穴
暈咗	暈過去
暈浪	暈船
暈晒大浪	入迷
暈晒浪	入迷
暈船浪	暈船
雲吞	餛飩
雲吞麵	餛飩麵
暈舵舵	頭暈暈
勻勻	每次
雲耳	木耳
混沌	迷糊
混吉	瞎鬧
運滯	倒運
雲呢拿	香草
雲呢拿草	香草
雲呢拿雪糕	香草冰淇淋
混混沌沌	迷迷糊糊
混入去	混進去
屈	冤屈
屈	強迫
屈	扭
屈餐懵	被別人陷害
屈親	扭傷
屈親隻腳	扭傷了腳
屈親隻手	扭傷了手
屈親條腰	扭傷了腰
屈得就屈	陷害別人
屈喺屋企	蹲在家裡
屈氣	憋氣
屈去後便	繞到後邊去
屈質	局促
屈佢食隻死貓	陷害別人
屈尾十	掉頭
屈悶	心中憋氣發悶
屈蛇	偷渡
屈水	勒索別人的金錢
屈鐵線	彎鐵絲
屈斷咗	撅斷了
核	核兒
核突	難看
搲著數	佔便宜
搲料	搜集材料
搲銀	拼命地賺錢
搲水	到處賺錢
van	小巴
van仔	小巴
𠿭	玩
𠿭場	娛樂場所
𠿭妹	愛玩樂的女孩
work	有效
VCD機	影音光碟機
we𠿭𠿭	出來玩
永世	一輩子
永世都記得	一輩子都忘不了
𢫕	扔
𢫕甩	扔掉
泳灘	海濱浴場
𢫕頭	搖頭
窩	鉚
窩輪	權證
喎	喔
喎	喔
禾	稻子
禾蟲	輪沙蟲
禾稈	稻草
禾稈草	稻草
禾造	水稻的收成
禾鐮	鐮刀
和頭酒	謝罪酒
禾塘	曬場
喎	喔
𢰸	壞了
𢰸蛋	臭蛋
watt	瓦
鑊	鐵鍋
鑊鏟	鍋鏟
鑊黸	鍋燼
枉	白白地
王	凱
枉費	白費
枉做	白幹
枉做人	白活了
黃	熟
黃花筒	黃花魚
黃花筒鹹魚	鹹黃花魚
黃蜂	馬蜂
黃蜂竇	馬蜂窩
皇家飯店	監獄
黃金檔期	黃金放映期
黃黚黚	黃黃的
黃猄	麂子
黃瓜造	黃瓜旺季
黃瓜酸	醃酸黃瓜
皇氣	警察
黃犬	蚯蚓
黃朝百晏	日上三竿
黃蜞	螞蟥
王老五	單身漢
黃綠醫生	庸醫
黃面婆	妻子
黃泥	黃土
黃芽白	大白菜
黃皮	黃彈
黃色架步	色情場所
黃糖	紅糖
黃黃哋	淺黃色
往日	過去
旺	熱鬧
旺菜	淡菜
旺區	熱鬧地區
烏低	俯下
烏低身	彎腰
烏低頭	低頭
烏低條腰	彎腰
烏低腰	彎腰
烏燈黑火	黑燈瞎火
烏都文	烏爾都語
烏都語	烏爾都語
烏冬麵	烏龍麵
污糟	髒
污糟錢	髒錢
污糟邋遢	骯髒
污糟貓	很髒的人
污糟衫	髒衣服
污糟嘢	髒東西
烏欖	橄欖
烏哩單刀	亂
烏喱馬扠	亂
烏龍	糊塗
烏龍事	糊塗事
烏龍王	糊塗蟲
污水渠	下水道
烏鼠	糊裡糊塗的人
污煙障氣	亂糟糟
烏蠅	蒼蠅
糊	和
糊仔	糊糊
湖水藍	淺藍
鬍鬚	鬍子
鬍鬚公	大鬍子
鬍鬚勒特	滿臉鬍子
鬍鬚佬	大鬍子
鬍鬚刨	刮臉刀
胡混	混日子
胡胡混混	混日子
護壆層	基堤
煨	烘烤
煨番薯	烤番薯
回	退
回貨	退貨
回樽	退瓶子
回樽費	退瓶費
回南	轉暖
回南天	回暖天氣
回水	退錢
回佣	回扣
會唔會	會不會
會彈唔會唱	只會說不會做
會會哋	會一點兒
會錯意	誤解
碗	飯碗
腕錶	手錶
碗篤	碗底
換膊	換肩
換檔	換搭檔
玩具舖	玩具店
換衫	換衣服
換屎片	換尿布
也文也武	耀武揚威
廿	二十
廿八	二十八
廿八歲	二十八歲
廿七	二十七
廿九	二十九
廿幾歲	二十多歲
廿六	二十六
廿蚊	二十塊錢
廿五	二十五
廿三	二十三
廿四	二十四
廿四孝	孝順
廿一	二十一
廿二	二十二
跴	踩
跴單車	騎自行車
喫	吃
喫飯	吃飯
𨅝	蹬
𨅝開度門	把門踹開
𨅝一腳	踹一腳
曳曳	淘氣
曳	劣
曳	皮
曳貨	劣貨
曳嘢	次東西
曳到死	調皮得要命
陰	害
陰	暗害
陰	陰險
𩬎	劉海
陰毒	惡毒
陰乾	漸漸消瘦
陰功	殘忍
陰功鬼	缺德鬼
陰騭	缺德
陰騭事	虧心事
陰力	柔勁
陰濕	陰險
陰聲細氣	小聲小氣
陰司紙	紙錢
陰陰凍	冷
陰人	算計別人
飲	喝
飲品	飲料
飲杯	碰杯
飲茶	下館子
飲茶	喝茶
飲茶錢	酒飯錢
飲大咗	酒喝多了
飲大咗兩杯	醉了
飲啖茶	喝口茶
飲啖水	喝口水
飲得	酒量大
飲到面紅紅	喝得面紅耳赤
飲翻杯喇	喝一杯吧
飲管	吸管
飲下午茶	喝下午茶
飲酒	喝酒
飲醉	喝醉
飲醉酒	喝醉了
飲醉咗	喝醉了
飲早茶	喝早茶
飲衫	禮服
飲水	喝水
飲勝	乾杯
飲勝佢	幹了它
飲傻仔水	喝酒
飲頭啖湯	嘗到甜頭
飲筒	吸管
飲飲食食	吃吃喝喝
飲嘢	喝酒
任揀唔嬲	隨便挑
任講唔嬲	儘管說
任攞唔嬲	隨意拿
任…唔嬲	隨便…
任食唔嬲	隨便吃
任睇唔嬲	隨便看
因	算
因住	當心
因住電親	當心觸電
因住凍親	當心著涼
因住嚟	當心
因乜事	為什麼
因咩事	為什麼
因由	原因
忍唔到	忍不住
忍唔住	忍不住
印	印章
印傭	印尼傭人
人辦	樣版
人情	賀禮
人哋	人家
人間蒸發	不見蹤影
人夾人緣	物以類聚
人工	工資
人工好奀	工資很低
人工奀過鬼	工資很少
人客	客人
人仔	人民幣
人仔	小孩
人嚟！	來人！
人龍	隊排得很長
人唔似人，鬼唔似鬼	落魄
人怕噅，米怕篩	人怕別人多次懇求，人就怕被人哀求
人細鬼大	人小鬼大
人蛇	偷渡者
人衰行路打倒褪	人倒霉
人事	人情
人頭豬腦	蠢笨
人頭湧湧	人山人海
人有我有	人家有的我也有
人有三急	要上廁所
引	吸引
翕眼	眨眼
入	放進
入	進
挹	招
入便	裡面
入牆櫃	壁櫥
入錢	存錢
入錯行	選錯了職業
入廠	住院
入廠大修	做手術
入大學	上大學
入大學讀書	上大學唸書
入到去	進去
入到	進入
入伙	入住
入貨	進貨
入房坐	進屋裡坐
入口	吃進去
入戲	投入
入去	進去
入行	入門
入閘口	進剪票口
入樽	扣籃
入球	進球
入嚟	進來
入嚟坐	進來坐
入嚟啦	進來吧
入唔到	進不了
入味	可口
入面	裡面
入屋叫人，入廟拜神	入鄉隨俗
入腦	記住
入晒我數	全都怪我吧
挹手	招手
入城	進城
入息	收入
入息好奀	收入很低
入數	入賬
入圍	入選
一把火	生氣
一餅嘢	一萬塊
一便	一邊
一便…，一便…	一邊…，一邊…
一般嘅	一般的
一般嚟講	一般來說
一齊	一起
一揪一掕	一串串的
一車搏雙馬	一車兌雙馬
一場街坊	鄰里一場
一場兄弟	兄弟一場
一場老友	老朋友一場
一場朋友	老朋友一場
一場相識	相識一場
一次過	一次性
一大拃	一大把
一擔擔	一樣的
一凸一凹	坑坑窪窪
一凸一凹	性格不同
一啲	些
一啲啲	一點點
一啲都唔	一點也不
一啲都唔知	一點也不知道
一啲都唔奇	一點都不奇怪
一丁友	一個人
一度	一個地方
一督就穿	一戳就破
一戙都冇	一文不值
一家大細	全家人
一家仔乸	一家老小
一雞	一元
一拮就穿	一戳就破
一嚿飯	飯桶
一嚿飯噉	笨
一嚿嚿	一塊塊
一嚿水	一百塊
一嚿雲	雲裡霧裡
一頸血	傷亡慘重
一句到尾	一句話
一句講晒	總括而言
一句鐘	一個小時
一句話都唔聲	一句話都不說
一腳踢	包幹
一哥	第一名
一哥	老大
一哥	警務處處長
一個崩	一個子兒
一個餅印	完全相同
一個啫	一個而已
一個字	五分鍾
一個做好，一個做醜	一個唱紅臉，一個唱白臉
一個仙	一分錢
一個仙都唔值	一文不值
一個二個	一個個
一桿入洞	一桿進洞
一吓	一下子
一吓間	一下子
一係	要麼
一係…一係…	一是…一是…
一口價	實價
一學就識	一學便會
一齋兩雜	兩葷一素
一齋三雜	三葷一素
一劑見功	一服見效
一陣	一會兒
一陣間	一會兒
一陣見	一會兒見
一隻屐	垂頭喪氣
一張嘢	一塊
一支公	一個人
一字咁淺	淺顯易懂
一直行	一直走
一直去	一直走
一早	早就
一竹篙打沉一船人	以偏蓋全
一竹篙打晒一船人	以偏蓋全
一竹篙打死一船人	以偏蓋全
一竹篙揇沉一船人	以偏蓋全
一竹篙揇咗一船人	以偏蓋全
一盅兩件	一杯茶加兩個點心
一住…一住…	邊…邊…
一粒骰噉	個子矮
一輪嘴	一口氣
一路	一直
一路都有	一直都有
一路…一路…	一邊…一邊…
一路以為	一直以為
一碌杉	呆板
一碌杉噉	呆板
一碌葛	呆板
一碌葛噉	呆板
一碌木	呆板
一碌木噉	呆板
一碌薯	呆板
一碌薯噉	呆板
一唔係	要不然
一蚊雞	一元
一味	盡
一面屁	一鼻子灰
一粒色	個子小
一凹一凸	坑坑窪窪
一凹一凸	性格不同
一額汗	一把汗
一排	一陣子
一拍兩散	一刀兩斷
一泡氣	一肚子氣
一泡眼淚	熱淚盈眶
一炮搏雙象	一炮兌雙象
一啤兩啤	一對兩對
一啤啤	一對對
一皮嘢	一萬塊
一鋪	一盤
一鋪翻唐山	什麼都不管了
一仆一碌	狼狽
一生人	一輩子
一世	一輩子
一世流流長	一輩子時間長
一世人	一輩子
一身蟻	一身麻煩
一身鬆	解除了負擔
一實	一定
一手揸住	一手抓著
一時時	有時
一時唔小心	一時大意
一時三刻	一時
一時一樣	反覆無常
一式	一樣
一頭	一邊
一頭家	一家
一頭霧水	滿頭霧水
一頭…一頭…	一邊兒…一邊兒…
一條氣	一股勁
一條氣	氣喘吁吁
一條氣	氣壞了
一肚屎計	一肚子鬼主意
一鑊	一次
一鑊泡	一塌糊塗
一鑊熟	一鍋端
一人少句	別吵了
一日	一天
一日	整天
一日	總之
一日到黑	老是
一嘢	一下
一於	堅決
一於噉話	就這樣辦吧
一於噉話啦	就這樣辦吧
一於係噉	就這麼定
一於係噉啦	就這樣吧
一於係噉話	就這麼定了
一於唔	堅決不
一於唔畀佢去	堅決不讓他去
一於唔制	堅決不答應
日	天
日更	白班
日光日白	光天化日
日子流流長	時間很漫長
日子耐咗	日子久了
日常用品	日用品
日頭	太陽
日頭青青	白天
日頭唔好講人，夜晚唔好講鬼	說曹操，曹操就到
日日	天天
優	提
憂	愁
優翻條褲	把褲子往上提溜
優褲	提褲子
優鞋	提鞋子
優襪	提襪子
憂心	擔心
友	傢伙
友	朋友
油	油漆
由	任由
由得	任由
由得佢喇	隨他便吧
由得你	隨你便
友仔	小子
由佢喇	隨他便吧
柚皮	柚子皮
幼	細
幼稚園	幼兒園
幼冷	細毛線
幼沙	細沙
幼細	細
幼滑	細滑
油	上油
由	從
遊車河	乘車遊覽
由得佢	算了吧
由得你…都得	隨便你…都行
遊埠	遊歷
油灰水	刷牆
油角	油炸餃子
油缸	油箱
由…講起	從…說起
油器	油炸食物
油渣	柴油
油炸鬼	油條
油漬	油的污跡
尤其係	尤其是
油梅	黃彈
油淰淰	油膩膩
油皮	黃彈
油舖	雜貨店
由細到大	從小到大
游水	游泳
游水池	游泳池
油上油漆	漆上油漆
遊船河	坐船遊覽
由頭到腳	從上到下
由頭嚟過	從頭再來
由頭睇到落尾	從頭到尾看一遍
油桐油	上桐油
遊魂	夢遊
油油	上漆
由而家開始	從現在開始
魷魚	槍烏賊
有把炮	有把握
有板有眼	有條理
有寶	了不起
有寶咩	有什麼稀罕的
有傳	據悉
有得…	有…的
有得震冇得瞓	擔驚受怕
有得震無得瞓	極害怕
有得走盞	有迴旋餘地
有得賣	有貨賣
有得擝	有希望
有得諗	值得考慮
有得你睇	有你瞧的
有得飲	有人請客
有突	有餘
有埞	有空間
有埞坐	有地方坐
有啲	有點
有啲震	有點發抖
有啲阻滯	有點麻煩
有啲唔妥	有點不對勁
有啲聲氣	有一點希望
有啲聲氣	有一點消息
有啲時	有時候
有啲燒	有點發燒
有翻咁上下	有本事
有分數	心中有數
有份	參與
有份	可以
有份	有自己一份
有feel	有感覺
有風駛盡𢃇	得理不饒人
有價講	可以討價還價
有計	有辦法
有金執咩	那有金子嗎？
有咁啱得咁蹺	這麼巧呀
有吉士	有膽量
有幾度散手	有點兒本事
有幾何	不常
有幾手嘢	有點本事
有嗰句，講嗰句	實話實說，實不相瞞
有古講咯	說來話長
有鬼用	沒用
有骨	帶刺
有過節	有仇
有限	不多
有口齒	有信用
有揸拿	有把握
有站慢	有下車的
有讚有彈	有褒有貶
有陣時	有時候
有著數	有便宜
有之	可能
有姿勢冇實際	金玉其外
有咗	懷孕了
有咗肚	懷孕
有傾有講	有說有笑
有規有矩	循規蹈矩
有辣有唔辣	有利有弊
有理冇理	不管怎麼樣
有兩度	有兩下子
有兩度散手	有兩下子
有兩手	有兩下子
有料	有本事
有料到	有本事
有落	有下車的
有路數	有門路
有慢	有下車的
有米	有錢
有紋有路	有條理
有乜冬瓜豆腐	有什麼三長兩短
有乜咁巴閉	有什麼了不起的
有乜咁出奇	世界上的事
有乜好傾	沒有什麼好談的了
有乜噏乜	有什麼話就說什麼
有乜事幹	有何貴幹
有乜咿喐	有什麼動靜
有乜用	有啥用
有味	餿
有名有份	名正言順
有面	有面子
有毛有翼	長大了
有冇	有沒有
有冇得擝	有沒有沒有希望
有冇攪錯	有沒有搞錯
有冇聲氣	有沒有希望
有挐褦	有關
有諗頭	有頭腦
油𥹉𥹉	油乎乎
有眼見	看見
有眼睇	看見
有銀	有錢
有銀搵	有錢可賺
有我喺度	有我在
有排	有好一陣子
有排等	夠等的了
有排你等	夠你等的
有排你學	夠你學的
有排你做	夠你忙的
有殺錯冇放過	寧枉勿縱
有心	故意
有心	謝謝關心
有身紀	懷孕
有些少	有一點
冇聲氣	有希望
冇聲氣	有消息
有聲氣喇	有希望了
有術	有辦法
有事慢慢講	有事好說
有食神	有口福
有少少	有一點
有睇頭	好看
有頭冇尾	虎頭蛇尾
有頭威冇尾陣	虎頭蛇尾
有頭有主	有頭兒
有頭有路	有來由
有頭有尾	有始有終
有頭有面	有面子
有剔士	有品味
有拖冇欠	有借有還
有碗話碗，有碟話碟	有一說一，有二說二
有人讚有人彈	有褒有貶
有癮	過癮
有一日	有一天
有日	有一天
有爺生無乸教	有爹生沒娘教
有嘢	有問題
有嘢	有東西
有嘢豆	有嘢豆
有嘢到	有本事
有嘢講	有話說
有嘢做	有事做
有嘢慢慢講	有事慢慢說
有嘢食	有東西吃
有嘢同…講	有話跟…說
有嘢同佢講	有話跟他說
有嘢話你知	有事告訴你
有樣學樣	模仿
有型	帥
有型有款	像個樣子
有腰骨	有骨氣
右便	右邊
又點話	又怎麼著
又喊又笑	又哭又笑
又係	那倒是
又係噃	倒也是
又啱	有道理
又屙又嘔	上吐下瀉
又平又靚	價廉物美
右手便	右邊
又衰咗	又失敗了
右軚	方向盤在右邊的汽車
右軚車	方向盤在右邊的汽車
右撓	右撇子
又…又盛	又…又什麼的
椰菜	包菜
椰菜花	菜花
椰子戟	椰子餅
夜冷舖	賣二手貨的店舖
爺爺	祖父
椰蓉	椰末兒
嘢	傳染
嘢	東西
惹	傳染
惹	挑逗
惹畀	傳染給
野仔	私生子
惹咗	染上
嘢埋…	傳染給…
惹埋	傳染
嘢埋我	傳染給我
野味	山珍
惹味	好味道
惹屎上身	招來麻煩
嘢少	不可小看
惹痰	生痰
夜	晚
夜場	夜總會
夜啲	晚一點
夜啲啦	妄想
夜更	夜班
夜鬼	夜貓子
夜過頭	太晚了
夜冷	舊貨
夜冷貨	舊貨
夜麻麻	深夜
夜晚	晚上
夜晚黑	晚上
夜遊神	夜貓子
贏波	球隊贏得了比賽
贏翻	贏回
錐	刺
錐	錐子
約	巷
約莫	大概
藥材舖	中藥舖
若果	如果
藥水膠布	創可貼
若然	如果
若然之	如果
潤	挖苦
膶	肝
膶腸	鴨肝香腸
抰	抖
樣	樣子
抰被	抖開被子
樣衰	醜
洋貨舖	百貨商店
羊牯	傻瓜
羊公	公羊
洋樓	洋房
羊毛棉氈	羊毛棉毯
羊乸	母羊
羊扒	羊排
洋芫茜	香芹
養畜牲	養牲口
樣樣事	每件事
樣樣嘢	每個東西
依	這
姨	姨母
𪘲	齜牙
醫病	治病
依便	這邊
衣車	縫衣機
依次	這次
醫得翻	能治好
依啲	這些
依度	這邊
醫翻嘥藥費	活著也浪費空氣
依個	這個
依個時候	這時
衣櫃	衣櫥
𪘲起棚牙	齜著牙
𪘲開嘴笑	咧著嘴笑
𪘲開棚牙	齜著牙
醫好	治好
E仔	搖頭丸
姨仔	小姨子
依種	這種
伊拉七	一般
伊撈七	一般
𪘲牙𠾴哨	笑咧咧
𪘲牙鬆弶	齜著牙
依排	最近
醫生紙	病假證明
伊士	酵母
依時	按時
依時依候	準時
依時依候嚟到	準時到
依時依候上班	準時上班
醫肚	填肚子
醫肚先	先吃點東西
伊挹	不嚴肅
伊挹	調情
姨姨	阿姨
咿咿挹挹	卿卿我我
EU	衝鋒隊
咿喐	動靜
噫	哦
椅	椅子
倚憑	依靠
椅墊	軟墊子
椅薦	坐墊
意大利話	意大利語
意粉	意大利麵
意味住	意味著
意頭	兆頭
宜得	巴不得
而家	現在
而係	而是
兒嬉	差
姨丈	姨父
移咗民	死了
姨媽	姨母
姨媽到	來月經
姨媽巾	衛生巾
姨甥	姨姪
姨甥女	姨姪女
衣衣哎哎	鬼叫
宜咿哦哦	囉哩囉唆
耳	把子
耳仔	耳朵
耳仔窿	耳孔
耳仔軟	耳根軟
耳珠	耳垂
耳窿	耳孔
以心為心	將心比心
耳屎	耳垢
耳性	記性
耳筒	耳機
二百	兩百
二千	兩千
二打六	半瓶醋
易到極	易如反掌
義工	志工
易過借火	易如反掌
易過食豆腐	易如反掌
易過食生菜	易如反掌
二仔底	基礎差
易做	好辦
econ	經濟學
二萬	兩萬
二奶	情婦
二五仔	叛徒
二世祖	阿斗
二十蚊	二十塊
二少	丈夫的二哥
二攤	二手貨
二攤貨	二手貨
易話為	好商量
易入口	容易吃進去
益	對…有利
抑或	還是
亦	也
翼	翅膀
亦都	也
亦都係	也是
亦即係	也就是
醃尖	挑剔
厭	膩
嫌費事	嫌麻煩
鹽蛇	壁虎
驗身	體檢
煙	愛司
煙鏟	煙鬼
煙塵	塵土
煙塵滾滾	塵土飛揚
煙花	煙火
煙灰盅	煙灰缸
煙霞	霾
煙仔	香煙
煙仔檔	香煙攤兒
煙製食物	燻製食物
煙韌	韌
煙三文魚	燻鮭魚
煙士	愛司
煙頭	煙蒂
煙通	煙囪
煙友	煙民
煙肉	燻肉
躽	挺
躽起個大肚腩	挺著個大肚皮
躽胸	挺胸
躽胸凸肚	腆著胸脯挺著肚子
演算法	算法
演嘢	賣弄
燕	燕子
燕梳	保險
然之後	然後
現錢	現金
現暫	到目前為止
現銀	現金
現銀交易	現金交易
現銀生意	現金生意
應份	應該
英靈	Eng
lit	英文文學
英泥	水泥
應承	答應
鷹粟粉	玉米粉
影	拍
影低	拍下
映電影	放電影
影張相	拍張照片
影樓	照相館
影唔到	拍不到
映眼	顯眼
影衰	丟臉
影衰晒	丟臉
影相	拍照
影相機	照相機
影相佬	攝影師
影相舖	照相館
影印	複印
影印機	複印機
應付唔到	應付不了
型	酷
型爆	帥呆了
型到痺	酷斃
型仔	帥
營幕	帳篷
型男	帥男
型男索女	俊男美女
營運總監	首席運營官
認親認戚	拉關係
認低威	服輸
認得	認識
認到	認出來
認真	確實
認住	覺得
認掯	逞英雄
認叻	逞強
認唔到	認不出來
認衰仔	自謙
認屎認屁	自以為是
認數	認帳
醃	醃
醃鹹菜	醃酸菜
醃鹹蛋	醃鹹鴨蛋
熱到飛起	非常熱
熱到流晒汗	熱得直冒汗
熱到死	熱死了
熱痱	痱子
熱啡	熱咖啡
熱過頭	太熱了
熱氣	上火
熱朱古力	熱巧克力
熱辣辣	很熱
熱檸茶	熱檸檬茶
熱線	專線
熱頭	太陽
熱天	夏天
熱熱哋	熱熱的
夭	摳
腰骨	腰
腰骨	骨氣
腰骨硬	耿介
腰骨痛	腰痛
夭漿糊	摳糨糊
夭牙罅	剔牙
夭心夭肺	頂撞
夭耳屎	挖耳垢
要唔係	要不然
要唔要	要不要
瑤柱	乾貝
遙控	遙控器
搖身搖勢	身子搖來搖去
搖搖板	蹺蹺板
搖搖馬	搖馬
於是乎	於是
瘀	丟臉
瘀	瘀血
瘀	諷刺
魚檔	魚店
瘀黑	因瘀血而發黑
魚仔	小魚
瘀咗	皮膚青腫
瘀晒	被撞得青一塊紫一塊的
魚春	魚卵
魚蛋	魚丸
魚蛋河	魚丸粉麵
魚蛋麵	魚肉丸子湯麵
魚膠	明膠
娛記	跑娛樂新聞的記者
魚缸	水族館
魚骨	魚刺
魚欄	水產店
魚柳	魚肉
魚露	魚醬
魚尾釘	雙腳釘
魚尾夾	長尾夾
魚腩	容易上當的人
魚腩	魚肚子肉
魚扒	魚排
魚片	魚片兒
魚卜	魚鰾
魚生	生魚片
魚生粥	魚片粥
魚塘壆	魚塘邊的基堤
魚丸	魚肉丸子
魚蓉	魚肉糜
雨粉	毛毛雨
雨粉粉	細雨紛飛
乳鴿	幼鴿子
與共	和
雨遮	雨傘
乳豬	小豬
與及	以及
雨褸	雨衣
雨溦	毛毛雨
雨溦仔	毛毛雨
雨溦溦	毛毛細雨
雨毛	毛毛雨
雨水天	雨天
預	預計
預咗	早料到
預早	預先
預埋	算一份
預埋我	算我
預鬆啲	留有餘地
褥	褥子
喐	動
喐	揍
喐不得其正	動彈不得
喐親	動輒
喐親就…	動不動就…
喐啲	動輒
喐啲就…	動不動就…
喐都唔喐	一動也不動
喐動	動
喐吓	動輒
喐吓喐吓	一動一動
喐嚟喐去	動來動去
喐身	動身
喐身喐勢	站不定
喐手	動手
喐手打人	動手打人
喐手喐腳	動手動腳
喐喐貢	亂動
喐喐吓	一動一動
肉	心兒
肉赤	心疼
肉隨砧板上	任人宰割
肉彈	騷貨
肉檔	肉舖
肉緊	緊張
褥仔	軟墊子
肉粒	肉丁
玉鈪	玉鐲
肉扒	肉排
肉票	人質
肉酸	噁心
肉痛	心疼
淵	痛
冤崩爛臭	臭氣熏天
淵到死	酸痛死了
淵到死	非常痛
淵痛	酸痛
鴛鴦	不成對兒
鴛鴦	咖啡茶
鴛鴦茶	咖啡茶
鴛鴦筷	一長一短的筷子
鴛鴦房	蜜月套房
鴛鴦鞋	一隻一個樣兒的鞋
鴛鴦襪	不是一對的襪子
鴛鴦門	不對稱的兩扇門
鴛鴦眼	異色瞳
丸仔	藥丸
怨	抱怨
怨唱	埋怨
鉛筆刨	削鉛筆器
元寶蠟燭	紙錢蠟燭
元寶蠟燭香	紙錢蠟燭
完場	比賽結束了
原始碼	源碼
原子筆	圓珠筆
圓碌碌	圓圓
芫茜	芫荽
圓肉	龍眼肉
薳	植物的嫩莖
軟笪笪	軟綿綿
遠得滯	太遠了
軟腳蟹	腿發軟
軟仔	白粉
軟瀨瀨	軟綿綿
軟腍腍	軟綿綿的
軟匹匹	軟綿綿
軟皮蛇	癩皮狗
軟熟	柔軟
軟雪糕	霜淇淋
軟荏荏	軟綿綿
湧	搶
絨	呢絨
擁躉	擁護者
絨褲	呢子褲
湧去	紛紛去
絨褸	呢大衣
湧晒	搶光
絨衫	呢子上衣
蓉	稀爛
容乜易	很容易
蓉蓉爛爛	破破爛爛
用家	使用者
用嚟	用來
越幫越忙	幫倒忙
月份牌	日曆
月光	月亮
越嚟越	越來越
月尾	月底
越諗越火滾	越想越惱火
越食越開胃	越吃越想吃
月頭	月初
月台	站台
粵語殘片	粵語舊片子
